ID,NumPosts,NumPostsPerDay,NumPostsPerActiveDay,StartTime,EndTime,Duration(days),SleepDays,ActiveDays,ActiveRate,SleepTimes,NumCommenters,NumLdPractices,NumNonLd,SetLdPractices,NumLdCommenter,NumNonLdCommenter,SetLdCommenter,labels
1,3,0.003921569,1,2010-12-19T16:17:53Z,2013-01-21T21:11:21Z,765,762,3,0.003921569,4,3,2,1,"{'LD3': 1, 'LD1': 1}",2,1,"{'LD3': 1, 'LD1': 1}",Feature
2,10,0.011641444,2,2010-12-19T16:22:54Z,2013-04-26T16:04:39Z,859,854,5,0.005820722,5,8,3,7,"{'LD3': 1, 'LD6': 1, 'LD1': 1}",3,5,"{'LD3': 1, 'LD6': 1, 'LD1': 1}",Brainstorming
3,17,0.072649573,1.307692308,2010-12-19T16:24:45Z,2011-08-09T16:25:09Z,234,221,13,0.055555556,13,12,3,14,"{'LD1': 1, 'LD6': 1, 'LD3': 1}",3,9,"{'LD1': 1, 'LD6': 1, 'LD3': 1}","Brainstorming,Wallet"
4,1,0.5,1,2010-12-19T16:28:57Z,2010-12-21T03:01:29Z,2,1,1,0.5,1,1,1,0,{'LD4': 1},1,0,{'LD4': 1},
5,5,0.089285714,2.5,2010-12-19T20:06:45Z,2011-02-13T09:22:02Z,56,54,2,0.035714286,2,2,1,4,{'LD5': 1},1,1,{'LD5': 1},Feature
6,5,0.019230769,1.666666667,2010-12-20T12:29:43Z,2011-09-06T06:46:58Z,260,257,3,0.011538462,3,4,2,3,"{'LD1': 1, 'LD2': 1}",2,2,"{'LD1': 1, 'LD2': 1}",Brainstorming
7,8,0.005677786,2.666666667,2010-12-20T13:53:07Z,2014-10-28T18:28:34Z,1409,1406,3,0.00212917,2,4,2,6,"{'LD4': 1, 'LD2': 1}",1,3,"{'LD4': 1, 'LD2': 1}","Feature,P2P"
8,4,0.011461318,1,2010-12-20T13:59:42Z,2011-12-03T18:24:00Z,349,345,4,0.011461318,3,2,2,2,"{'LD3': 1, 'LD4': 1}",1,1,"{'LD3': 1, 'LD4': 1}",Feature
12,2,0.003558719,2,2010-12-22T14:40:16Z,2012-07-05T21:28:38Z,562,561,1,0.001779359,2,2,0,2,{},0,2,{},Feature
13,5,0.011547344,1.25,2010-12-22T14:51:28Z,2012-02-27T23:34:18Z,433,429,4,0.009237875,4,3,1,4,{'LD4': 1},1,2,{'LD4': 1},Brainstorming
14,5,0.011655012,1.25,2010-12-22T14:58:10Z,2012-02-23T20:59:18Z,429,425,4,0.009324009,5,5,2,3,"{'LD1': 1, 'LD3': 1}",2,3,"{'LD1': 1, 'LD3': 1}",Feature
15,5,0.008896797,1,2010-12-22T14:59:44Z,2012-07-05T21:29:18Z,562,557,5,0.008896797,6,5,1,4,{'LD4': 1},1,4,{'LD4': 1},Feature
16,2,0.006097561,1,2010-12-29T19:13:05Z,2011-11-21T20:49:10Z,328,326,2,0.006097561,3,2,0,2,{},0,2,{},"Bug,GUI"
17,2,0.142857143,1,2010-12-31T07:20:02Z,2011-01-14T00:19:55Z,14,12,2,0.142857143,2,1,1,1,{'LD1': 1},1,0,{'LD1': 1},
18,1,0.0125,1,2011-01-02T23:40:33Z,2011-03-22T23:46:46Z,80,79,1,0.0125,1,1,0,1,{},0,1,{},Bug
20,3,0.006578947,1.5,2011-01-05T09:47:18Z,2012-04-04T19:17:00Z,456,454,2,0.004385965,2,1,1,2,{'LD1': 1},1,0,{'LD1': 1},Feature
22,2,0.060606061,1,2011-01-06T04:48:23Z,2011-02-07T21:08:12Z,33,31,2,0.060606061,1,2,1,1,{'LD5': 1},1,1,{'LD5': 1},Bug
25,4,0.363636364,2,2011-01-09T23:43:12Z,2011-01-20T19:39:08Z,11,9,2,0.181818182,2,2,1,3,{'LD4': 1},1,1,{'LD4': 1},Bug
26,1,0.090909091,1,2011-01-10T18:08:04Z,2011-01-20T21:17:14Z,11,10,1,0.090909091,2,1,0,1,{},0,1,{},Bug
28,4,0.019138756,1.333333333,2011-01-13T00:12:39Z,2011-08-09T16:26:56Z,209,206,3,0.014354067,3,3,1,3,{'LD3': 1},1,2,{'LD3': 1},Bug
39,1,0.007246377,1,2011-01-20T21:28:26Z,2011-06-07T18:31:50Z,138,137,1,0.007246377,2,1,0,1,{},0,1,{},Bug
44,1,0.1,1,2011-01-27T18:02:37Z,2011-02-06T01:10:39Z,10,9,1,0.1,1,1,0,1,{},0,1,{},
47,1,0.003773585,1,2011-01-28T21:27:20Z,2011-10-20T05:53:31Z,265,264,1,0.003773585,2,1,1,0,{'LD5': 1},1,0,{'LD5': 1},Feature
48,9,0.004729375,1.125,2011-01-29T10:54:12Z,2016-04-14T19:53:33Z,1903,1895,8,0.004203889,9,7,4,5,"{'LD4': 3, 'LD6': 1}",3,4,"{'LD4': 3, 'LD6': 1}",Bug
49,5,0.011600928,1.666666667,2011-01-30T18:47:38Z,2012-04-04T19:18:05Z,431,428,3,0.006960557,3,3,3,2,"{'LD3': 1, 'LD4': 2}",2,1,"{'LD3': 1, 'LD4': 2}",Bug
60,6,0.014184397,1.5,2011-02-07T16:07:38Z,2012-04-04T19:18:53Z,423,419,4,0.009456265,3,5,0,6,{},0,5,{},"Brainstorming,Wallet"
64,3,0.007177033,1.5,2011-02-11T21:00:36Z,2012-04-04T19:20:16Z,418,416,2,0.004784689,2,3,1,2,{'LD3': 1},1,2,{'LD3': 1},"Bug,GUI"
65,3,0.012048193,1.5,2011-02-13T11:06:32Z,2011-10-20T05:45:32Z,249,247,2,0.008032129,3,3,1,2,{'LD5': 1},1,2,{'LD5': 1},Docs
66,2,0.095238095,1,2011-02-13T12:50:05Z,2011-03-05T16:22:52Z,21,19,2,0.095238095,2,2,0,2,{},0,2,{},
67,4,0.009592326,1,2011-02-13T14:22:57Z,2012-04-04T19:21:47Z,417,413,4,0.009592326,5,3,1,3,{'LD4': 1},1,2,{'LD4': 1},"Bug,Docs"
68,20,0.021857923,2.222222222,2011-02-13T21:30:13Z,2013-08-16T03:29:53Z,915,906,9,0.009836066,9,10,5,15,"{'LD4': 2, 'LD3': 2, 'LD5': 1}",4,6,"{'LD4': 2, 'LD3': 2, 'LD5': 1}","Brainstorming,Feature,Wallet"
69,1,0.111111111,1,2011-02-14T19:11:21Z,2011-02-22T22:10:48Z,9,8,1,0.111111111,1,1,0,1,{},0,1,{},Bug
71,1,0.000643501,1,2011-02-14T21:55:02Z,2015-05-18T09:38:35Z,1554,1553,1,0.000643501,2,1,0,1,{},0,1,{},Brainstorming
73,1,0.009174312,1,2011-02-19T13:42:02Z,2011-06-07T18:31:31Z,109,108,1,0.009174312,2,1,0,1,{},0,1,{},Feature
75,3,0.010526316,1.5,2011-02-21T22:26:17Z,2011-12-03T18:32:30Z,285,283,2,0.007017544,2,2,1,2,{'LD5': 1},1,1,{'LD5': 1},Bug
76,5,0.065789474,2.5,2011-02-22T00:28:44Z,2011-05-08T01:36:04Z,76,74,2,0.026315789,3,2,3,2,"{'LD4': 1, 'LD5': 2}",2,0,"{'LD4': 1, 'LD5': 2}",Bug
77,1,0.00952381,1,2011-02-22T22:18:53Z,2011-06-07T18:31:20Z,105,104,1,0.00952381,2,1,0,1,{},0,1,{},
78,2,2,2,2011-02-23T12:24:15Z,2011-02-23T22:52:07Z,1,0,1,1,0,1,1,1,{'LD3': 1},1,0,{'LD3': 1},
80,2,0.027027027,1,2011-02-23T23:38:27Z,2011-05-08T01:36:31Z,74,72,2,0.027027027,3,2,1,1,{'LD4': 1},1,1,{'LD4': 1},Bug
84,2,0.010638298,1,2011-02-28T04:34:52Z,2011-09-03T05:31:35Z,188,186,2,0.010638298,2,2,0,2,{},0,2,{},Feature
86,2,0.666666667,2,2011-03-01T02:54:31Z,2011-03-03T03:17:00Z,3,2,1,0.333333333,1,2,1,1,{'LD4': 1},1,1,{'LD4': 1},Bug
87,1,0.005376344,1,2011-03-01T21:08:52Z,2011-09-03T05:29:37Z,186,185,1,0.005376344,2,1,0,1,{},0,1,{},Feature
89,2,0.005586592,1,2011-03-02T23:16:13Z,2012-02-23T21:01:01Z,358,356,2,0.005586592,3,2,0,2,{},0,2,{},Bug
94,1,0.05,1,2011-03-03T20:14:04Z,2011-03-22T23:46:46Z,20,19,1,0.05,1,1,0,1,{},0,1,{},Bug
99,5,0.057471264,1.666666667,2011-03-05T15:28:53Z,2011-05-30T21:53:57Z,87,84,3,0.034482759,2,3,3,2,"{'LD4': 2, 'LD6': 1}",2,1,"{'LD4': 2, 'LD6': 1}",Feature
100,6,0.027272727,1.2,2011-03-05T21:57:13Z,2011-10-11T19:02:10Z,220,215,5,0.022727273,6,5,3,3,"{'LD1': 1, 'LD4': 1, 'LD3': 1}",3,2,"{'LD1': 1, 'LD4': 1, 'LD3': 1}",Feature
102,2,0.011428571,1,2011-03-06T15:45:10Z,2011-08-28T09:13:31Z,175,173,2,0.011428571,2,2,0,2,{},0,2,{},Brainstorming
103,1,0.005434783,1,2011-03-06T23:38:01Z,2011-09-06T06:50:55Z,184,183,1,0.005434783,1,1,0,1,{},0,1,{},Feature
108,1,1,1,2011-03-08T14:47:03Z,2011-03-08T16:50:46Z,1,0,1,1,0,1,1,0,{'LD2': 1},1,0,{'LD2': 1},
119,1,0.2,1,2011-03-16T05:17:56Z,2011-03-20T20:51:28Z,5,4,1,0.2,1,1,0,1,{},0,1,{},
128,1,0.004901961,1,2011-03-21T19:21:20Z,2011-10-10T21:37:55Z,204,203,1,0.004901961,2,1,0,1,{},0,1,{},"Bug,GUI"
129,1,0.00625,1,2011-03-22T02:19:34Z,2011-08-28T09:26:57Z,160,159,1,0.00625,2,1,1,0,{'LD4': 1},1,0,{'LD4': 1},
130,7,0.042168675,1.75,2011-03-22T03:45:05Z,2011-09-03T05:12:35Z,166,162,4,0.024096386,4,4,5,2,"{'LD4': 2, 'LD3': 2, 'LD1': 1}",3,1,"{'LD4': 1, 'LD3': 2, 'LD1': 1}",Bug
145,3,0.015228426,1,2011-04-06T07:43:30Z,2011-10-20T05:53:18Z,197,194,3,0.015228426,3,2,2,1,"{'LD6': 1, 'LD5': 1}",2,0,"{'LD6': 1, 'LD5': 1}",Feature
146,1,1,1,2011-04-09T18:23:54Z,2011-04-09T19:21:02Z,1,0,1,1,0,1,0,1,{},0,1,{},
147,11,0.275,1.571428571,2011-04-10T00:29:42Z,2011-05-19T14:39:24Z,40,33,7,0.175,3,8,4,7,"{'LD5': 2, 'LD3': 2}",4,4,"{'LD5': 2, 'LD3': 2}",
148,2,0.008474576,1,2011-04-12T14:04:18Z,2011-12-03T18:40:07Z,236,234,2,0.008474576,2,1,1,1,{'LD1': 1},1,0,{'LD1': 1},Feature
156,5,0.833333333,1.666666667,2011-04-14T05:34:36Z,2011-04-19T06:17:56Z,6,3,3,0.5,1,1,4,1,"{'LD4': 1, 'LD3': 3}",1,0,"{'LD4': 1, 'LD3': 1}",
158,1,0.005291005,1,2011-04-15T04:36:12Z,2011-10-20T05:52:52Z,189,188,1,0.005291005,2,1,1,0,{'LD5': 1},1,0,{'LD5': 1},GUI
166,2,0.017391304,1,2011-04-17T05:46:26Z,2011-08-09T17:42:25Z,115,113,2,0.017391304,2,1,0,2,{},0,1,{},
170,2,1,1,2011-04-19T16:39:27Z,2011-04-21T03:17:27Z,2,0,2,1,0,2,0,2,{},0,2,{},
171,1,1,1,2011-04-19T21:44:32Z,2011-04-20T14:34:53Z,1,0,1,1,0,1,0,1,{},0,1,{},
172,1,0.001066098,1,2011-04-20T14:58:51Z,2013-11-12T15:34:23Z,938,937,1,0.001066098,2,1,0,1,{},0,1,{},Bug
175,1,1,1,2011-04-20T20:42:16Z,2011-04-21T06:38:14Z,1,0,1,1,0,1,1,0,{'LD4': 1},1,0,{'LD4': 1},
188,2,0.011428571,1,2011-04-28T18:01:36Z,2011-10-20T06:44:36Z,175,173,2,0.011428571,2,2,0,2,{},0,2,{},"Feature,Wallet"
191,1,0.004651163,1,2011-05-02T20:44:12Z,2011-12-03T18:34:57Z,215,214,1,0.004651163,2,1,0,1,{},0,1,{},"Bug,Refactoring"
200,1,1,1,2011-05-07T20:08:09Z,2011-05-08T01:41:07Z,1,0,1,1,0,1,0,1,{},0,1,{},
206,1,0.000787402,1,2011-05-09T00:21:06Z,2014-10-29T14:48:16Z,1270,1269,1,0.000787402,2,1,0,1,{},0,1,{},"Brainstorming,Feature"
207,10,0.064516129,5,2011-05-09T03:23:44Z,2011-10-10T21:39:53Z,155,153,2,0.012903226,2,3,6,4,"{'LD3': 2, 'LD4': 4}",3,0,"{'LD3': 2, 'LD4': 2}","Bug,GUI"
210,3,0.001867995,1,2011-05-09T15:22:26Z,2015-10-01T12:29:45Z,1606,1603,3,0.001867995,3,3,2,1,"{'LD3': 1, 'LD2': 1}",2,1,"{'LD3': 1, 'LD2': 1}","Feature,Wallet"
211,4,0.002301496,1,2011-05-09T16:08:31Z,2016-02-09T16:28:31Z,1738,1734,4,0.002301496,5,4,2,2,"{'LD1': 1, 'LD4': 1}",2,2,"{'LD1': 1, 'LD4': 1}",Refactoring
216,5,0.017361111,1.666666667,2011-05-10T06:49:28Z,2012-02-22T06:17:02Z,288,285,3,0.010416667,2,3,3,2,"{'LD1': 2, 'LD3': 1}",2,1,"{'LD1': 2, 'LD3': 1}","Bug,GUI"
228,1,0.333333333,1,2011-05-16T19:48:10Z,2011-05-19T14:34:55Z,3,2,1,0.333333333,1,1,1,0,{'LD2': 1},1,0,{'LD2': 1},
231,1,0.004950495,1,2011-05-17T22:53:11Z,2011-12-05T16:30:00Z,202,201,1,0.004950495,1,1,0,1,{},0,1,{},"Bug,GUI"
236,1,0.047619048,1,2011-05-18T17:26:36Z,2011-06-07T18:33:59Z,21,20,1,0.047619048,1,1,0,1,{},0,1,{},Bug
237,1,0.00310559,1,2011-05-18T22:09:58Z,2012-04-04T19:25:27Z,322,321,1,0.00310559,2,1,0,1,{},0,1,{},Bug
239,1,0.005,1,2011-05-18T22:15:34Z,2011-12-04T08:56:34Z,200,199,1,0.005,1,1,1,0,{'LD5': 1},1,0,{'LD5': 1},Bug
240,1,0.125,1,2011-05-18T22:18:31Z,2011-05-26T20:25:59Z,8,7,1,0.125,1,1,0,1,{},0,1,{},Bug
241,1,0.012048193,1,2011-05-18T23:25:56Z,2011-08-09T17:02:24Z,83,82,1,0.012048193,1,1,0,1,{},0,1,{},
242,1,1,1,2011-05-19T02:32:14Z,2011-05-19T13:28:48Z,1,0,1,1,0,1,1,0,{'LD4': 1},1,0,{'LD4': 1},
243,1,0.125,1,2011-05-19T07:02:18Z,2011-05-27T00:18:55Z,8,7,1,0.125,1,1,0,1,{},0,1,{},Bug
248,3,0.016483516,1,2011-05-21T01:47:00Z,2011-11-18T18:41:58Z,182,179,3,0.016483516,3,3,2,1,"{'LD4': 1, 'LD3': 1}",2,1,"{'LD4': 1, 'LD3': 1}",Bug
252,2,0.006269592,1,2011-05-22T02:27:42Z,2012-04-04T19:28:02Z,319,317,2,0.006269592,3,2,0,2,{},0,2,{},"Feature,Refactoring"
257,1,0.001132503,1,2011-05-23T15:07:07Z,2013-10-22T08:12:51Z,883,882,1,0.001132503,2,1,1,0,{'LD5': 1},1,0,{'LD5': 1},Feature
258,9,0.028301887,1,2011-05-23T19:23:31Z,2012-04-04T19:26:05Z,318,309,9,0.028301887,9,7,3,6,"{'LD3': 2, 'LD4': 1}",3,4,"{'LD3': 2, 'LD4': 1}","Brainstorming,Bug"
263,1,0.083333333,1,2011-05-25T11:59:41Z,2011-06-05T14:33:11Z,12,11,1,0.083333333,1,1,0,1,{},0,1,{},Bug
271,15,0.036855037,1.875,2011-05-26T08:38:53Z,2012-07-05T21:31:20Z,407,399,8,0.01965602,7,8,4,11,"{'LD1': 2, 'LD4': 2}",2,6,"{'LD1': 2, 'LD4': 1}","Brainstorming,Feature"
272,1,0.003367003,1,2011-05-26T11:08:25Z,2012-03-17T11:22:47Z,297,296,1,0.003367003,2,1,0,1,{},0,1,{},Feature
279,2,0.001642036,1,2011-05-27T01:15:07Z,2014-09-25T09:45:20Z,1218,1216,2,0.001642036,3,2,1,1,{'LD4': 1},1,1,{'LD4': 1},Refactoring
298,1,1,1,2011-06-05T17:07:14Z,2011-06-05T17:10:26Z,1,0,1,1,0,1,0,1,{},0,1,{},
299,1,0.010752688,1,2011-06-05T20:26:19Z,2011-09-06T06:59:33Z,93,92,1,0.010752688,1,1,0,1,{},0,1,{},Bug
301,1,0.015384615,1,2011-06-06T02:44:24Z,2011-08-09T16:59:03Z,65,64,1,0.015384615,1,1,1,0,{'LD4': 1},1,0,{'LD4': 1},
305,6,0.015189873,1.2,2011-06-06T23:12:16Z,2012-07-05T21:46:36Z,395,390,5,0.012658228,5,6,0,6,{},0,6,{},"Brainstorming,Feature"
306,2,0.021978022,2,2011-06-07T14:08:25Z,2011-09-06T07:04:53Z,91,90,1,0.010989011,1,1,1,1,{'LD3': 1},1,0,{'LD3': 1},Bug
307,1,0.010989011,1,2011-06-07T16:40:48Z,2011-09-06T07:05:22Z,91,90,1,0.010989011,2,1,1,0,{'LD3': 1},1,0,{'LD3': 1},Bug
308,1,0.00116144,1,2011-06-08T08:57:51Z,2013-10-15T12:23:00Z,861,860,1,0.00116144,1,1,1,0,{'LD5': 1},1,0,{'LD5': 1},"Docs,Refactoring"
309,1,0.000402253,1,2011-06-08T17:21:09Z,2018-03-29T14:50:08Z,2486,2485,1,0.000402253,1,1,1,0,{'LD5': 1},1,0,{'LD5': 1},Feature
313,1,0.008196721,1,2011-06-11T10:51:56Z,2011-10-10T21:53:44Z,122,121,1,0.008196721,2,1,1,0,{'LD3': 1},1,0,{'LD3': 1},Refactoring
316,2,1,1,2011-06-14T23:33:28Z,2011-06-16T21:19:51Z,2,0,2,1,0,2,0,2,{},0,2,{},
317,1,0.000588235,1,2011-06-16T00:14:37Z,2016-02-09T16:36:11Z,1700,1699,1,0.000588235,2,1,0,1,{},0,1,{},Refactoring
318,1,0.000309023,1,2011-06-16T00:20:24Z,2020-04-24T19:55:05Z,3236,3235,1,0.000309023,2,1,1,0,{'LD4': 1},1,0,{'LD4': 1},"Brainstorming,Consensus"
320,3,3,3,2011-06-16T15:08:55Z,2011-06-16T23:31:06Z,1,0,1,1,0,2,1,2,{'LD5': 1},1,1,{'LD5': 1},
321,1,0.003412969,1,2011-06-16T19:58:40Z,2012-04-04T19:21:10Z,293,292,1,0.003412969,2,1,1,0,{'LD4': 1},1,0,{'LD4': 1},"Bug,Wallet"
325,1,0.083333333,1,2011-06-18T13:34:31Z,2011-06-29T22:32:20Z,12,11,1,0.083333333,2,1,0,1,{},0,1,{},
328,1,0.004016064,1,2011-06-18T22:10:22Z,2012-02-22T06:01:37Z,249,248,1,0.004016064,1,1,0,1,{},0,1,{},Bug
329,1,0.003571429,1,2011-06-18T22:22:41Z,2012-03-24T17:53:29Z,280,279,1,0.003571429,2,1,1,0,{'LD1': 1},1,0,{'LD1': 1},Bug
330,2,0.001994018,1,2011-06-19T00:21:18Z,2014-03-17T07:40:59Z,1003,1001,2,0.001994018,3,2,0,2,{},0,2,{},"Bug,GUI"
333,1,1,1,2011-06-20T00:53:48Z,2011-06-20T11:37:35Z,1,0,1,1,0,1,1,0,{'LD5': 1},1,0,{'LD5': 1},
338,1,0.002631579,1,2011-06-22T16:56:11Z,2012-07-05T21:44:19Z,380,379,1,0.002631579,2,1,0,1,{},0,1,{},"Brainstorming,Feature,Wallet"
339,4,0.003358522,1,2011-06-23T03:28:09Z,2014-09-25T09:59:50Z,1191,1187,4,0.003358522,4,4,2,2,{'LD3': 2},2,2,{'LD3': 2},"Brainstorming,Build system,Docs,Feature"
346,2,0.007017544,1,2011-06-25T22:39:37Z,2012-04-05T01:29:39Z,285,283,2,0.007017544,2,2,1,1,{'LD5': 1},1,1,{'LD5': 1},"Bug,GUI"
353,1,0.003533569,1,2011-06-27T01:54:48Z,2012-04-05T01:30:35Z,283,282,1,0.003533569,2,1,0,1,{},0,1,{},"Docs,Refactoring"
359,5,0.009823183,1.25,2011-06-28T08:17:44Z,2012-11-17T13:29:23Z,509,505,4,0.007858546,3,3,2,3,{'LD5': 2},1,2,{'LD5': 1},"Bug,Docs"
365,2,0.012658228,1,2011-06-29T17:23:07Z,2011-12-03T18:41:48Z,158,156,2,0.012658228,2,2,0,2,{},0,2,{},Feature
375,1,0.5,1,2011-07-03T08:48:21Z,2011-07-04T13:43:56Z,2,1,1,0.5,1,1,1,0,{'LD4': 1},1,0,{'LD4': 1},
377,1,0.027027027,1,2011-07-04T05:09:21Z,2011-08-09T17:17:06Z,37,36,1,0.027027027,1,1,0,1,{},0,1,{},
382,1,0.010204082,1,2011-07-05T09:09:52Z,2011-10-10T21:43:43Z,98,97,1,0.010204082,1,1,1,0,{'LD1': 1},1,0,{'LD1': 1},"Bug,GUI"
386,4,0.004179728,1,2011-07-07T00:19:42Z,2014-02-17T14:03:00Z,957,953,4,0.004179728,3,3,3,1,{'LD4': 3},3,0,{'LD4': 3},"Feature,GUI"
387,4,0.010958904,2,2011-07-07T06:39:49Z,2012-07-05T21:42:51Z,365,363,2,0.005479452,2,4,2,2,"{'LD1': 1, 'LD2': 1}",2,2,"{'LD1': 1, 'LD2': 1}","Feature,Wallet"
391,2,2,2,2011-07-08T16:30:22Z,2011-07-08T17:06:33Z,1,0,1,1,0,2,0,2,{},0,2,{},
393,3,0.011070111,1.5,2011-07-09T08:59:59Z,2012-04-05T01:32:25Z,271,269,2,0.007380074,2,3,1,2,{'LD3': 1},1,2,{'LD3': 1},"Bug,Docs,GUI"
397,1,1,1,2011-07-12T05:12:10Z,2011-07-13T04:02:53Z,1,0,1,1,0,1,0,1,{},0,1,{},
398,1,0.003731343,1,2011-07-12T11:55:28Z,2012-04-05T01:33:35Z,268,267,1,0.003731343,2,1,0,1,{},0,1,{},"Docs,Refactoring"
400,1,0.035714286,1,2011-07-12T17:13:05Z,2011-08-09T16:45:07Z,28,27,1,0.035714286,1,1,0,1,{},0,1,{},
407,1,0.011111111,1,2011-07-13T15:26:44Z,2011-10-10T21:43:03Z,90,89,1,0.011111111,2,1,0,1,{},0,1,{},"Bug,GUI"
416,4,0.04494382,1,2011-07-14T18:57:18Z,2011-10-10T21:45:08Z,89,85,4,0.04494382,3,4,1,3,{'LD1': 1},1,3,{'LD1': 1},"Bug,GUI"
425,3,0.022222222,1.5,2011-07-23T03:31:10Z,2011-12-04T09:06:26Z,135,133,2,0.014814815,2,2,1,2,{'LD3': 1},1,1,{'LD3': 1},Bug
429,1,0.00099108,1,2011-07-25T20:19:17Z,2014-04-29T13:42:53Z,1009,1008,1,0.00099108,1,1,0,1,{},0,1,{},Bug
433,2,0.009569378,1,2011-07-26T13:45:31Z,2012-02-19T18:49:34Z,209,207,2,0.009569378,2,2,1,1,{'LD3': 1},1,1,{'LD3': 1},Docs
441,2,0.022988506,1,2011-07-31T12:04:54Z,2011-10-25T16:27:37Z,87,85,2,0.022988506,3,2,1,1,{'LD4': 1},1,1,{'LD4': 1},Bug
449,1,1,1,2011-08-03T11:05:40Z,2011-08-03T13:27:53Z,1,0,1,1,0,1,0,1,{},0,1,{},
450,2,0.285714286,2,2011-08-03T14:12:18Z,2011-08-09T16:38:31Z,7,6,1,0.142857143,1,1,0,2,{},0,1,{},
453,6,0.214285714,1.2,2011-08-05T16:31:22Z,2011-09-01T18:59:35Z,28,23,5,0.178571429,4,4,0,6,{},0,4,{},Bug
455,1,0.003003003,1,2011-08-08T08:49:12Z,2012-07-05T21:40:10Z,333,332,1,0.003003003,1,1,0,1,{},0,1,{},"Bug,Docs"
469,3,0.027027027,1.5,2011-08-14T22:09:19Z,2011-12-03T18:45:58Z,111,109,2,0.018018018,2,2,1,2,{'LD1': 1},1,1,{'LD1': 1},Bug
471,3,0.003694581,1,2011-08-16T00:39:03Z,2013-11-04T14:27:31Z,812,809,3,0.003694581,4,1,2,1,"{'LD1': 1, 'LD5': 1}",1,0,"{'LD1': 1, 'LD5': 1}","Bug,Feature,Windows"
473,1,0.0078125,1,2011-08-16T15:17:19Z,2011-12-21T19:54:44Z,128,127,1,0.0078125,2,1,1,0,{'LD3': 1},1,0,{'LD3': 1},Bug
477,3,0.018181818,1,2011-08-24T19:22:06Z,2012-02-05T11:26:33Z,165,162,3,0.018181818,3,3,2,1,"{'LD4': 1, 'LD5': 1}",2,1,"{'LD4': 1, 'LD5': 1}",Docs
479,1,1,1,2011-08-30T03:53:25Z,2011-08-30T21:31:07Z,1,0,1,1,0,1,0,1,{},0,1,{},Wallet
482,3,0.333333333,1.5,2011-08-31T19:56:46Z,2011-09-09T13:34:38Z,9,7,2,0.222222222,2,3,1,2,{'LD3': 1},1,2,{'LD3': 1},"Bug,Wallet"
485,1,0.25,1,2011-09-02T13:42:31Z,2011-09-06T07:48:10Z,4,3,1,0.25,1,1,0,1,{},0,1,{},Bug
489,1,0.333333333,1,2011-09-03T07:56:58Z,2011-09-06T07:01:35Z,3,2,1,0.333333333,1,1,1,0,{'LD4': 1},1,0,{'LD4': 1},"Bug,Docs"
493,1,1,1,2011-09-05T21:27:28Z,2011-09-05T22:38:09Z,1,0,1,1,0,1,0,1,{},0,1,{},Bug
494,2,0.02247191,1,2011-09-05T22:42:33Z,2011-12-03T18:58:52Z,89,87,2,0.02247191,1,2,1,1,{'LD5': 1},1,1,{'LD5': 1},"Bug,Docs"
507,5,0.151515152,5,2011-09-08T11:15:59Z,2011-10-10T21:44:35Z,33,32,1,0.03030303,1,3,1,4,{'LD5': 1},1,2,{'LD5': 1},GUI
514,1,0.076923077,1,2011-09-14T09:29:28Z,2011-09-27T03:40:30Z,13,12,1,0.076923077,2,1,1,0,{'LD4': 1},1,0,{'LD4': 1},"Brainstorming,Bug,Docs"
515,4,0.019607843,4,2011-09-14T13:56:53Z,2012-04-05T02:08:09Z,204,203,1,0.004901961,1,3,2,2,"{'LD1': 1, 'LD3': 1}",2,1,"{'LD1': 1, 'LD3': 1}","Bug,Docs"
518,1,0.004926108,1,2011-09-15T21:05:08Z,2012-04-05T02:06:02Z,203,202,1,0.004926108,1,1,0,1,{},0,1,{},"Docs,Feature"
540,1,0.083333333,1,2011-09-29T01:24:25Z,2011-10-10T21:32:07Z,12,11,1,0.083333333,1,1,1,0,{'LD4': 1},1,0,{'LD4': 1},"Bug,GUI"
544,2,0.007168459,1,2011-10-01T19:33:53Z,2012-07-05T21:36:01Z,279,277,2,0.007168459,1,1,1,1,{'LD2': 1},1,0,{'LD2': 1},Bug
548,4,4,4,2011-10-03T17:13:35Z,2011-10-03T23:30:17Z,1,0,1,1,0,4,0,4,{},0,4,{},Brainstorming
571,4,0.023952096,1.333333333,2011-10-05T19:57:58Z,2012-03-19T21:24:41Z,167,164,3,0.017964072,3,4,1,3,{'LD2': 1},1,3,{'LD2': 1},"Bug,Wallet"
581,4,0.004395604,1.333333333,2011-10-10T21:22:32Z,2014-04-07T05:31:02Z,910,907,3,0.003296703,2,4,3,1,"{'LD4': 1, 'LD1': 2}",3,1,"{'LD4': 1, 'LD1': 2}","Bug,GUI"
589,3,0.018181818,1.5,2011-10-21T02:44:32Z,2012-04-02T19:06:25Z,165,163,2,0.012121212,2,2,2,1,"{'LD4': 1, 'LD5': 1}",2,0,"{'LD4': 1, 'LD5': 1}",Bug
594,2,0.011560694,1,2011-10-27T00:10:03Z,2012-04-16T08:25:21Z,173,171,2,0.011560694,1,1,1,1,{'LD5': 1},1,0,{'LD5': 1},"Bug,GUI"
595,1,0.0625,1,2011-10-28T20:53:35Z,2011-11-13T07:54:13Z,16,15,1,0.0625,1,1,1,0,{'LD3': 1},1,0,{'LD3': 1},Bug
596,13,0.012241055,1.857142857,2011-10-29T18:29:13Z,2014-09-25T10:29:33Z,1062,1055,7,0.006591337,5,4,0,13,{},0,4,{},Bug
599,1,0.00877193,1,2011-10-29T20:49:51Z,2012-02-20T18:55:43Z,114,113,1,0.00877193,2,1,0,1,{},0,1,{},Refactoring
601,1,0.001277139,1,2011-11-01T09:46:42Z,2013-12-23T06:11:19Z,783,782,1,0.001277139,1,1,1,0,{'LD2': 1},1,0,{'LD2': 1},Bug
605,5,0.020408163,1.25,2011-11-04T17:25:23Z,2012-07-05T22:01:52Z,245,241,4,0.016326531,3,5,2,3,{'LD3': 2},2,3,{'LD3': 2},Bug
610,1,0.001869159,1,2011-11-06T22:38:09Z,2013-04-23T23:32:25Z,535,534,1,0.001869159,2,1,0,1,{},0,1,{},Bug
612,1,1,1,2011-11-07T04:21:34Z,2011-11-07T16:01:05Z,1,0,1,1,0,1,0,1,{},0,1,{},
613,4,0.285714286,1.333333333,2011-11-07T20:04:14Z,2011-11-21T17:55:49Z,14,11,3,0.214285714,1,3,2,2,{'LD3': 2},2,1,{'LD3': 2},"Bug,GUI"
614,6,0.007566204,1.2,2011-11-07T21:38:18Z,2014-01-08T17:55:23Z,793,788,5,0.00630517,5,5,4,2,"{'LD3': 1, 'LD4': 3}",3,2,"{'LD3': 1, 'LD4': 2}","Docs,GUI"
615,1,1,1,2011-11-08T12:51:36Z,2011-11-08T19:05:15Z,1,0,1,1,0,1,1,0,{'LD6': 1},1,0,{'LD6': 1},GUI
616,5,0.044642857,1.666666667,2011-11-08T14:32:10Z,2012-02-27T21:25:59Z,112,109,3,0.026785714,2,4,3,2,"{'LD3': 1, 'LD4': 1, 'LD1': 1}",2,2,"{'LD3': 1, 'LD4': 1, 'LD1': 1}",Bug
620,1,0.006849315,1,2011-11-08T22:35:29Z,2012-04-02T18:57:42Z,146,145,1,0.006849315,1,1,1,0,{'LD4': 1},1,0,{'LD4': 1},"Bug,GUI"
621,1,0.001972387,1,2011-11-08T22:42:34Z,2013-03-29T09:12:55Z,507,506,1,0.001972387,1,1,0,1,{},0,1,{},GUI
622,3,0.005357143,1,2011-11-08T22:57:55Z,2013-05-21T07:07:35Z,560,557,3,0.005357143,3,2,0,3,{},0,2,{},GUI
623,3,0.001294219,1.5,2011-11-08T23:22:54Z,2018-03-14T14:26:17Z,2318,2316,2,0.000862813,2,3,1,2,{'LD3': 1},1,2,{'LD3': 1},"Feature,GUI"
624,2,0.003656307,1,2011-11-08T23:25:56Z,2013-05-08T06:03:27Z,547,545,2,0.003656307,2,2,1,1,{'LD5': 1},1,1,{'LD5': 1},GUI
625,5,2.5,2.5,2011-11-08T23:31:21Z,2011-11-10T15:20:55Z,2,0,2,1,0,2,2,3,"{'LD5': 1, 'LD3': 1}",2,0,"{'LD5': 1, 'LD3': 1}",GUI
626,1,0.004464286,1,2011-11-09T15:21:24Z,2012-06-19T20:39:03Z,224,223,1,0.004464286,1,1,0,1,{},0,1,{},Refactoring
627,2,0.002754821,1,2011-11-09T16:35:48Z,2013-11-04T14:39:33Z,726,724,2,0.002754821,3,2,0,2,{},0,2,{},GUI
628,4,1,4,2011-11-09T17:12:40Z,2011-11-13T07:47:22Z,4,3,1,0.25,1,3,2,2,{'LD1': 2},2,1,{'LD1': 2},"Bug,GUI"
637,2,0.02,1,2011-11-16T07:07:19Z,2012-02-23T21:39:25Z,100,98,2,0.02,3,2,1,1,{'LD4': 1},1,1,{'LD4': 1},
639,2,0.019417476,1,2011-11-17T10:28:10Z,2012-02-27T21:20:50Z,103,101,2,0.019417476,3,2,0,2,{},0,2,{},Bug
640,4,0.033057851,1,2011-11-18T05:05:38Z,2012-03-17T10:31:18Z,121,117,4,0.033057851,3,3,0,4,{},0,3,{},Bug
641,2,0.285714286,1,2011-11-18T09:14:48Z,2011-11-24T20:15:42Z,7,5,2,0.285714286,1,1,0,2,{},0,1,{},
642,2,0.014285714,1,2011-11-18T10:10:58Z,2012-04-05T19:43:45Z,140,138,2,0.014285714,2,2,1,1,{'LD2': 1},1,1,{'LD2': 1},Bug
643,2,0.008658009,2,2011-11-18T18:41:12Z,2012-07-05T21:57:27Z,231,230,1,0.004329004,1,1,0,2,{},0,1,{},
644,6,0.019480519,2,2011-11-19T01:06:23Z,2012-09-21T09:03:00Z,308,305,3,0.00974026,2,2,3,3,"{'LD3': 1, 'LD5': 2}",2,0,"{'LD3': 1, 'LD5': 2}",
645,2,0.020833333,1,2011-11-20T04:34:26Z,2012-02-23T21:40:28Z,96,94,2,0.020833333,2,1,0,2,{},0,1,{},
647,1,0.007462687,1,2011-11-20T22:08:26Z,2012-04-02T17:12:24Z,134,133,1,0.007462687,2,1,1,0,{'LD3': 1},1,0,{'LD3': 1},GUI
648,1,0.001129944,1,2011-11-21T00:36:36Z,2014-04-23T14:06:06Z,885,884,1,0.001129944,2,1,1,0,{'LD3': 1},1,0,{'LD3': 1},"GUI,Refactoring"
650,1,0.010989011,1,2011-11-21T10:41:23Z,2012-02-20T02:04:47Z,91,90,1,0.010989011,1,1,1,0,{'LD3': 1},1,0,{'LD3': 1},Bug
656,3,0.036144578,1.5,2011-11-23T07:09:46Z,2012-02-14T06:46:33Z,83,81,2,0.024096386,3,2,1,2,{'LD3': 1},1,1,{'LD3': 1},Bug
657,2,0.024096386,1,2011-11-23T07:11:48Z,2012-02-14T06:45:16Z,83,81,2,0.024096386,3,1,1,1,{'LD3': 1},1,0,{'LD3': 1},"GUI,Refactoring"
659,14,0.118644068,2.8,2011-11-23T20:18:03Z,2012-03-20T16:30:19Z,118,113,5,0.042372881,3,3,4,10,"{'LD1': 1, 'LD3': 3}",2,1,"{'LD1': 1, 'LD3': 2}",Bug
660,11,0.048672566,2.2,2011-11-23T20:39:14Z,2012-07-05T21:55:36Z,226,221,5,0.022123894,4,4,7,4,"{'LD3': 3, 'LD1': 2, 'LD4': 1, 'LD2': 1}",2,2,"{'LD3': 2, 'LD1': 2, 'LD4': 1, 'LD2': 1}",
661,1,1,1,2011-11-24T02:22:09Z,2011-11-24T11:35:09Z,1,0,1,1,0,1,0,1,{},0,1,{},
664,6,0.005479452,1.2,2011-11-26T02:35:52Z,2014-11-24T15:44:20Z,1095,1090,5,0.00456621,4,5,3,3,"{'LD1': 2, 'LD5': 1}",3,2,"{'LD1': 2, 'LD5': 1}","Build system,Refactoring"
665,2,1,2,2011-11-26T02:52:20Z,2011-11-27T19:54:27Z,2,1,1,0.5,1,2,0,2,{},0,2,{},
668,1,0.007692308,1,2011-11-27T16:41:40Z,2012-04-05T02:09:25Z,130,129,1,0.007692308,2,1,1,0,{'LD2': 1},1,0,{'LD2': 1},
671,2,0.024390244,2,2011-12-01T22:24:21Z,2012-02-21T12:56:18Z,82,81,1,0.012195122,2,1,1,1,{'LD3': 1},1,0,{'LD3': 1},GUI
672,1,1,1,2011-12-01T22:42:02Z,2011-12-01T23:56:10Z,1,0,1,1,0,1,1,0,{'LD1': 1},1,0,{'LD1': 1},
674,3,0.3,1.5,2011-12-02T01:02:52Z,2011-12-11T17:24:06Z,10,8,2,0.2,1,2,0,3,{},0,2,{},
675,1,1,1,2011-12-02T12:36:53Z,2011-12-02T14:51:50Z,1,0,1,1,0,1,0,1,{},0,1,{},
678,4,0.051948052,2,2011-12-03T16:29:42Z,2012-02-17T17:51:01Z,77,75,2,0.025974026,2,2,1,3,{'LD3': 1},1,1,{'LD3': 1},
680,3,0.010238908,1,2011-12-03T17:18:20Z,2012-09-21T08:26:11Z,293,290,3,0.010238908,2,2,0,3,{},0,2,{},
681,1,1,1,2011-12-03T19:30:27Z,2011-12-03T23:11:57Z,1,0,1,1,0,1,0,1,{},0,1,{},
684,8,0.011412268,1.6,2011-12-05T01:31:05Z,2013-11-04T14:58:02Z,701,696,5,0.007132668,6,6,3,5,"{'LD3': 2, 'LD4': 1}",3,3,"{'LD3': 2, 'LD4': 1}",
688,2,0.009433962,1,2011-12-07T17:07:47Z,2012-07-05T21:50:08Z,212,210,2,0.009433962,3,1,0,2,{},0,1,{},
689,2,0.018518519,1,2011-12-07T20:53:11Z,2012-03-24T17:53:52Z,108,106,2,0.018518519,3,1,0,2,{},0,1,{},"Bug,GUI"
692,3,0.044776119,1.5,2011-12-09T20:39:58Z,2012-02-14T06:44:54Z,67,65,2,0.029850746,2,2,0,3,{},0,2,{},
702,2,0.03125,2,2011-12-16T14:11:16Z,2012-02-17T17:52:38Z,64,63,1,0.015625,1,2,0,2,{},0,2,{},Bug
703,7,0.023972603,1.4,2011-12-16T15:17:18Z,2012-10-03T10:48:19Z,292,287,5,0.017123288,4,2,4,3,"{'LD5': 2, 'LD4': 1, 'LD1': 1}",1,1,"{'LD5': 1, 'LD4': 1, 'LD1': 1}","Bug,GUI"
711,23,0.5,4.6,2011-12-18T08:38:19Z,2012-02-01T17:21:04Z,46,41,5,0.108695652,3,3,6,17,"{'LD4': 1, 'LD3': 2, 'LD1': 2, 'LD6': 1}",2,1,"{'LD4': 1, 'LD3': 1, 'LD1': 1, 'LD6': 1}",Bug
713,6,0.041958042,2,2011-12-19T02:04:34Z,2012-05-09T15:34:13Z,143,140,3,0.020979021,3,4,1,5,{'LD2': 1},1,3,{'LD2': 1},GUI
718,2,0.019047619,1,2011-12-20T07:31:36Z,2012-04-02T19:02:08Z,105,103,2,0.019047619,2,2,1,1,{'LD4': 1},1,1,{'LD4': 1},
722,1,1,1,2011-12-22T16:38:46Z,2011-12-23T11:53:33Z,1,0,1,1,0,1,1,0,{'LD4': 1},1,0,{'LD4': 1},
724,4,0.020408163,2,2011-12-23T14:45:37Z,2012-07-05T21:49:09Z,196,194,2,0.010204082,2,2,2,2,"{'LD1': 1, 'LD4': 1}",2,0,"{'LD1': 1, 'LD4': 1}",GUI
725,2,0.010204082,1,2011-12-23T19:06:21Z,2012-07-05T21:49:01Z,196,194,2,0.010204082,2,2,1,1,{'LD4': 1},1,1,{'LD4': 1},Bug
729,21,2.333333333,7,2011-12-27T02:42:23Z,2012-01-04T23:53:29Z,9,6,3,0.333333333,2,6,7,14,"{'LD3': 2, 'LD1': 2, 'LD4': 2, 'LD2': 1}",5,1,"{'LD3': 1, 'LD1': 1, 'LD4': 2, 'LD2': 1}",
736,7,0.010339734,1,2012-01-02T21:50:11Z,2013-11-09T07:00:50Z,677,670,7,0.010339734,7,6,2,5,"{'LD3': 1, 'LD1': 1}",2,4,"{'LD3': 1, 'LD1': 1}","GUI,Refactoring"
739,5,0.038167939,1.25,2012-01-03T01:12:10Z,2012-05-12T23:45:13Z,131,127,4,0.030534351,3,3,1,4,{'LD4': 1},1,2,{'LD4': 1},
742,4,0.102564103,1.333333333,2012-01-03T17:24:03Z,2012-02-11T13:09:23Z,39,36,3,0.076923077,4,3,1,3,{'LD1': 1},1,2,{'LD1': 1},Bug
744,2,0.007662835,1,2012-01-04T23:16:35Z,2012-09-21T09:14:31Z,261,259,2,0.007662835,2,2,1,1,{'LD4': 1},1,1,{'LD4': 1},
745,1,0.02,1,2012-01-05T18:02:53Z,2012-02-23T21:03:46Z,50,49,1,0.02,1,1,0,1,{},0,1,{},
747,5,0.005035247,5,2012-01-06T20:28:16Z,2014-09-25T09:57:37Z,993,992,1,0.001007049,2,3,1,4,{'LD5': 1},1,2,{'LD5': 1},Bug
749,5,0.04587156,1,2012-01-07T17:02:18Z,2012-04-25T16:29:27Z,109,104,5,0.04587156,6,3,3,2,"{'LD3': 1, 'LD4': 2}",2,1,"{'LD3': 1, 'LD4': 2}","Bug,macOS"
751,2,0.002020202,1,2012-01-09T18:16:13Z,2014-09-25T10:03:25Z,990,988,2,0.002020202,2,2,0,2,{},0,2,{},Refactoring
753,8,0.307692308,2.666666667,2012-01-10T18:35:41Z,2012-02-05T09:17:33Z,26,23,3,0.115384615,2,3,1,7,{'LD5': 1},1,2,{'LD5': 1},
754,4,0.005154639,2,2012-01-11T01:53:13Z,2014-02-24T14:36:03Z,776,774,2,0.00257732,2,2,0,4,{},0,2,{},"Bug,GUI"
756,4,0.097560976,1.333333333,2012-01-13T23:56:10Z,2012-02-23T21:09:43Z,41,38,3,0.073170732,4,2,3,1,"{'LD4': 1, 'LD3': 1, 'LD2': 1}",2,0,"{'LD4': 1, 'LD3': 1, 'LD2': 1}",
760,3,0.142857143,1.5,2012-01-15T21:33:35Z,2012-02-05T11:16:39Z,21,19,2,0.095238095,1,3,1,2,{'LD4': 1},1,2,{'LD4': 1},
761,1,0.5,1,2012-01-16T02:43:18Z,2012-01-17T18:02:50Z,2,1,1,0.5,1,1,0,1,{},0,1,{},
763,4,0.001317957,1,2012-01-17T08:42:09Z,2020-05-08T23:44:40Z,3035,3031,4,0.001317957,4,4,0,4,{},0,4,{},"Feature,GUI"
772,1,0.066666667,1,2012-01-20T01:52:14Z,2012-02-03T22:31:18Z,15,14,1,0.066666667,1,1,0,1,{},0,1,{},
776,23,0.035330261,2.3,2012-01-23T16:18:03Z,2013-11-04T14:56:05Z,651,641,10,0.015360983,7,7,4,19,"{'LD4': 1, 'LD1': 2, 'LD6': 1}",1,6,"{'LD4': 1, 'LD1': 1, 'LD6': 1}",
779,1,0.001567398,1,2012-01-23T21:38:00Z,2013-10-22T05:34:54Z,638,637,1,0.001567398,2,1,0,1,{},0,1,{},
781,8,0.051282051,2,2012-01-24T15:38:38Z,2012-06-27T16:38:51Z,156,152,4,0.025641026,4,2,3,5,"{'LD3': 1, 'LD1': 1, 'LD5': 1}",2,0,"{'LD3': 1, 'LD1': 1, 'LD5': 1}",GUI
784,1,0.007352941,1,2012-01-25T20:09:03Z,2012-06-09T15:14:45Z,136,135,1,0.007352941,1,1,1,0,{'LD4': 1},1,0,{'LD4': 1},GUI
785,1,0.00063857,1,2012-01-26T18:14:59Z,2016-05-10T08:59:25Z,1566,1565,1,0.00063857,2,1,1,0,{'LD4': 1},1,0,{'LD4': 1},"Feature,GUI"
788,3,0.130434783,1.5,2012-01-30T08:38:43Z,2012-02-21T12:46:48Z,23,21,2,0.086956522,2,1,1,2,{'LD1': 1},1,0,{'LD1': 1},"Bug,GUI"
789,1,1,1,2012-01-31T10:19:23Z,2012-01-31T19:08:38Z,1,0,1,1,0,1,1,0,{'LD1': 1},1,0,{'LD1': 1},
791,3,0.019230769,3,2012-02-01T21:00:30Z,2012-07-05T21:53:53Z,156,155,1,0.006410256,1,2,0,3,{},0,2,{},Refactoring
793,1,1,1,2012-02-02T01:57:43Z,2012-02-02T15:29:41Z,1,0,1,1,0,1,1,0,{'LD1': 1},1,0,{'LD1': 1},
794,6,0.75,3,2012-02-03T02:42:01Z,2012-02-10T17:04:20Z,8,6,2,0.25,2,4,0,6,{},0,4,{},Bug
797,3,0.018181818,1,2012-02-04T10:50:59Z,2012-07-18T08:18:44Z,165,162,3,0.018181818,2,3,2,1,"{'LD1': 1, 'LD5': 1}",2,1,"{'LD1': 1, 'LD5': 1}","Bug,Windows"
809,12,0.018897638,2,2012-02-08T20:13:15Z,2013-11-04T14:51:31Z,635,629,6,0.009448819,7,6,8,4,"{'LD1': 1, 'LD3': 2, 'LD4': 3, 'LD5': 1, 'LD2': 1}",6,0,"{'LD1': 1, 'LD3': 2, 'LD4': 3, 'LD5': 1, 'LD2': 1}","Bug,Linux/Unix"
810,1,1,1,2012-02-08T21:02:18Z,2012-02-08T23:40:25Z,1,0,1,1,0,1,0,1,{},0,1,{},
814,5,0.263157895,1.666666667,2012-02-09T14:48:02Z,2012-02-27T21:23:22Z,19,16,3,0.157894737,2,3,0,5,{},0,3,{},"Bug,GUI"
815,4,0.2,2,2012-02-09T14:49:03Z,2012-02-28T21:35:23Z,20,18,2,0.1,1,3,1,3,{'LD3': 1},1,2,{'LD3': 1},Bug
819,9,0.169811321,4.5,2012-02-10T19:36:24Z,2012-04-03T18:22:38Z,53,51,2,0.037735849,1,3,3,6,"{'LD3': 2, 'LD5': 1}",3,0,"{'LD3': 2, 'LD5': 1}","Bug,GUI,Linux/Unix"
820,9,0.25,1.8,2012-02-11T08:16:28Z,2012-03-17T10:31:08Z,36,31,5,0.138888889,5,5,0,9,{},0,5,{},"Bug,Windows"
821,7,0.037037037,2.333333333,2012-02-11T10:17:26Z,2012-08-18T08:32:44Z,189,186,3,0.015873016,3,2,2,5,"{'LD4': 1, 'LD5': 1}",1,1,"{'LD4': 1, 'LD5': 1}","GUI,Refactoring"
824,1,0.000738552,1,2012-02-11T13:56:08Z,2015-10-27T11:32:45Z,1354,1353,1,0.000738552,2,1,0,1,{},0,1,{},"Bug,RPC/REST/ZMQ"
830,14,0.368421053,2.333333333,2012-02-13T06:46:00Z,2012-03-21T19:00:56Z,38,32,6,0.157894737,4,4,9,5,"{'LD3': 4, 'LD4': 3, 'LD1': 1, 'LD5': 1}",3,1,"{'LD3': 2, 'LD4': 2, 'LD1': 1, 'LD5': 1}","Bug,Windows"
832,2,0.666666667,1,2012-02-13T22:58:03Z,2012-02-16T18:54:28Z,3,1,2,0.666666667,1,1,1,1,{'LD4': 1},1,0,{'LD4': 1},"Bug,Linux/Unix"
835,8,0.01025641,1.333333333,2012-02-14T17:44:48Z,2014-04-04T06:41:59Z,780,774,6,0.007692308,6,5,2,6,"{'LD4': 1, 'LD5': 1}",2,3,"{'LD4': 1, 'LD5': 1}","Bug,GUI"
839,1,0.001589825,1,2012-02-15T13:49:55Z,2013-11-05T00:00:50Z,629,628,1,0.001589825,1,1,0,1,{},0,1,{},GUI
840,1,0.333333333,1,2012-02-15T16:44:21Z,2012-02-17T17:52:02Z,3,2,1,0.333333333,1,1,0,1,{},0,1,{},
846,1,0.25,1,2012-02-16T09:01:44Z,2012-02-19T17:28:18Z,4,3,1,0.25,1,1,1,0,{'LD2': 1},1,0,{'LD2': 1},
851,3,1.5,3,2012-02-16T16:22:42Z,2012-02-17T17:53:36Z,2,1,1,0.5,1,2,1,2,{'LD3': 1},1,1,{'LD3': 1},
856,1,0.2,1,2012-02-17T14:48:53Z,2012-02-21T22:59:11Z,5,4,1,0.2,1,1,0,1,{},0,1,{},
860,2,0.2,2,2012-02-17T19:21:42Z,2012-02-27T00:12:20Z,10,9,1,0.1,1,2,1,1,{'LD3': 1},1,1,{'LD3': 1},GUI
861,4,0.006920415,1,2012-02-17T19:50:13Z,2013-09-17T11:36:17Z,578,574,4,0.006920415,3,2,2,2,{'LD5': 2},1,1,{'LD5': 1},"GUI,Refactoring"
874,1,0.166666667,1,2012-02-20T03:10:09Z,2012-02-25T18:13:48Z,6,5,1,0.166666667,1,1,1,0,{'LD3': 1},1,0,{'LD3': 1},"Bug,GUI"
877,6,0.206896552,1.2,2012-02-20T20:41:56Z,2012-03-20T17:30:44Z,29,24,5,0.172413793,5,4,3,3,"{'LD1': 1, 'LD4': 1, 'LD3': 1}",3,1,"{'LD1': 1, 'LD4': 1, 'LD3': 1}","Bug,GUI,macOS"
879,5,0.227272727,2.5,2012-02-21T10:31:49Z,2012-03-14T06:42:42Z,22,20,2,0.090909091,1,3,2,3,"{'LD3': 1, 'LD4': 1}",2,1,"{'LD3': 1, 'LD4': 1}","Bug,Linux/Unix"
880,1,0.25,1,2012-02-21T12:52:36Z,2012-02-25T08:33:18Z,4,3,1,0.25,1,1,1,0,{'LD3': 1},1,0,{'LD3': 1},"GUI,Refactoring"
881,5,0.714285714,1.666666667,2012-02-21T22:54:27Z,2012-02-28T22:41:59Z,7,4,3,0.428571429,1,2,2,3,"{'LD4': 1, 'LD1': 1}",1,1,"{'LD4': 1, 'LD1': 1}","Bug,Wallet"
888,3,0.002411576,1,2012-02-23T11:27:40Z,2015-07-21T09:55:34Z,1244,1241,3,0.002411576,3,2,0,3,{},0,2,{},Refactoring
901,2,0.666666667,2,2012-02-26T11:24:30Z,2012-02-28T17:21:54Z,3,2,1,0.333333333,1,2,0,2,{},0,2,{},
903,2,0.003241491,2,2012-02-26T20:52:07Z,2013-11-04T14:45:40Z,617,616,1,0.001620746,2,2,1,1,{'LD1': 1},1,1,{'LD1': 1},
908,2,0.043478261,1,2012-02-27T17:41:53Z,2012-04-12T19:01:27Z,46,44,2,0.043478261,1,1,2,0,"{'LD3': 1, 'LD5': 1}",1,0,"{'LD3': 1, 'LD5': 1}",
916,3,1.5,1.5,2012-03-05T11:22:21Z,2012-03-06T16:48:45Z,2,0,2,1,0,2,2,1,{'LD4': 2},2,0,{'LD4': 2},
919,12,0.428571429,3,2012-03-05T18:45:52Z,2012-04-01T23:24:07Z,28,24,4,0.142857143,3,4,5,7,"{'LD4': 1, 'LD6': 2, 'LD5': 2}",2,2,"{'LD4': 1, 'LD6': 1, 'LD5': 1}",
920,1,1,1,2012-03-08T04:17:25Z,2012-03-08T17:11:20Z,1,0,1,1,0,1,0,1,{},0,1,{},
921,10,0.263157895,3.333333333,2012-03-08T04:53:05Z,2012-04-14T06:27:23Z,38,35,3,0.078947368,1,4,2,8,{'LD1': 2},2,2,{'LD1': 2},
922,1,0.1,1,2012-03-09T22:36:16Z,2012-03-19T00:20:54Z,10,9,1,0.1,1,1,0,1,{},0,1,{},Bug
923,3,3,3,2012-03-10T18:11:09Z,2012-03-10T19:05:28Z,1,0,1,1,0,3,1,2,{'LD4': 1},1,2,{'LD4': 1},
925,1,0.333333333,1,2012-03-10T20:29:00Z,2012-03-12T22:21:38Z,3,2,1,0.333333333,1,1,0,1,{},0,1,{},
927,3,0.027522936,1.5,2012-03-10T21:20:03Z,2012-06-27T16:38:22Z,109,107,2,0.018348624,2,2,1,2,{'LD5': 1},1,1,{'LD5': 1},GUI
935,3,0.003236246,1,2012-03-12T19:42:38Z,2014-09-25T10:04:41Z,927,924,3,0.003236246,3,2,2,1,"{'LD4': 1, 'LD5': 1}",1,1,"{'LD4': 1, 'LD5': 1}","GUI,Refactoring,Wallet"
937,2,0.010526316,1,2012-03-14T14:11:43Z,2012-09-20T07:45:21Z,190,188,2,0.010526316,2,2,1,1,{'LD5': 1},1,1,{'LD5': 1},Refactoring
939,1,0.058823529,1,2012-03-15T08:34:45Z,2012-04-01T07:01:06Z,17,16,1,0.058823529,1,1,0,1,{},0,1,{},
940,1,0.2,1,2012-03-15T13:01:46Z,2012-03-19T13:06:52Z,5,4,1,0.2,2,1,0,1,{},0,1,{},
944,5,0.007518797,1.25,2012-03-17T10:17:23Z,2014-01-10T12:22:08Z,665,661,4,0.006015038,3,2,3,2,"{'LD4': 2, 'LD6': 1}",2,0,"{'LD4': 2, 'LD6': 1}",Bug
945,4,0.072727273,2,2012-03-17T14:04:39Z,2012-05-11T13:52:17Z,55,53,2,0.036363636,2,1,1,3,{'LD3': 1},1,0,{'LD3': 1},"Bug,GUI"
955,5,0.294117647,1.666666667,2012-03-19T22:50:41Z,2012-04-05T13:17:06Z,17,14,3,0.176470588,2,3,4,1,"{'LD4': 2, 'LD3': 2}",3,0,"{'LD4': 2, 'LD3': 2}","Bug,Wallet,Windows"
956,7,0.4375,1.75,2012-03-20T01:36:07Z,2012-04-04T19:07:43Z,16,12,4,0.25,2,4,3,4,"{'LD3': 1, 'LD4': 1, 'LD5': 1}",3,1,"{'LD3': 1, 'LD4': 1, 'LD5': 1}","Refactoring,Windows"
957,1,0.001550388,1,2012-03-20T02:04:27Z,2013-12-24T08:43:09Z,645,644,1,0.001550388,2,1,1,0,{'LD3': 1},1,0,{'LD3': 1},"Bug,Wallet"
958,2,1,2,2012-03-20T07:12:36Z,2012-03-21T20:48:34Z,2,1,1,0.5,1,1,0,2,{},0,1,{},
963,2,0.181818182,1,2012-03-20T20:01:03Z,2012-03-31T14:19:47Z,11,9,2,0.181818182,1,1,1,1,{'LD2': 1},1,0,{'LD2': 1},"GUI,Refactoring"
977,9,1.5,2.25,2012-03-22T17:09:25Z,2012-03-28T14:34:33Z,6,2,4,0.666666667,1,6,4,5,{'LD4': 4},3,3,{'LD4': 3},"Bug,Windows"
978,7,0.046979866,1.75,2012-03-22T23:40:55Z,2012-08-18T08:35:45Z,149,145,4,0.026845638,2,2,0,7,{},0,2,{},Bug
981,6,1.5,2,2012-03-24T14:04:14Z,2012-03-28T07:02:57Z,4,1,3,0.75,1,2,1,5,{'LD4': 1},1,1,{'LD4': 1},
982,4,0.363636364,2,2012-03-25T01:59:06Z,2012-04-04T19:08:25Z,11,9,2,0.181818182,3,2,2,2,"{'LD4': 1, 'LD3': 1}",2,0,"{'LD4': 1, 'LD3': 1}",Bug
993,6,0.002022927,1.2,2012-03-26T16:56:51Z,2020-05-08T23:45:36Z,2966,2961,5,0.001685772,4,5,2,4,"{'LD4': 1, 'LD5': 1}",2,3,"{'LD4': 1, 'LD5': 1}","Feature,Windows"
997,4,0.010899183,2,2012-03-27T16:19:47Z,2013-03-29T09:23:17Z,367,365,2,0.005449591,3,3,4,0,"{'LD1': 2, 'LD5': 1, 'LD3': 1}",3,0,"{'LD1': 2, 'LD5': 1, 'LD3': 1}",
999,2,0.004761905,1,2012-03-28T03:37:19Z,2013-05-21T07:08:51Z,420,418,2,0.004761905,1,2,1,1,{'LD6': 1},1,1,{'LD6': 1},
1000,2,0.08,1,2012-03-28T06:59:14Z,2012-04-21T13:15:17Z,25,23,2,0.08,3,1,1,1,{'LD3': 1},1,0,{'LD3': 1},
1001,1,0.001703578,1,2012-03-28T11:55:05Z,2013-11-04T14:44:11Z,587,586,1,0.001703578,1,1,0,1,{},0,1,{},
1005,4,0.003058104,2,2012-03-28T23:05:53Z,2015-10-27T11:32:32Z,1308,1306,2,0.001529052,2,2,2,2,{'LD4': 2},1,1,{'LD4': 1},Refactoring
1011,4,0.001844168,1.333333333,2012-03-29T20:19:20Z,2018-03-06T21:57:26Z,2169,2166,3,0.001383126,3,4,1,3,{'LD1': 1},1,3,{'LD1': 1},Bug
1012,10,0.294117647,2,2012-03-29T20:50:47Z,2012-05-02T07:14:39Z,34,29,5,0.147058824,3,5,6,4,"{'LD3': 4, 'LD4': 1, 'LD5': 1}",3,2,"{'LD3': 3, 'LD4': 1, 'LD5': 1}",Refactoring
1013,3,3,3,2012-03-30T12:06:34Z,2012-03-30T22:40:18Z,1,0,1,1,0,3,0,3,{},0,3,{},
1015,4,4,4,2012-03-31T00:17:07Z,2012-03-31T18:34:32Z,1,0,1,1,0,2,3,1,"{'LD4': 1, 'LD1': 1, 'LD5': 1}",2,0,"{'LD4': 1, 'LD1': 1, 'LD5': 1}",
1020,1,0.0625,1,2012-03-31T16:57:17Z,2012-04-16T09:24:46Z,16,15,1,0.0625,1,1,1,0,{'LD3': 1},1,0,{'LD3': 1},GUI
1024,5,1,1.666666667,2012-04-02T03:47:57Z,2012-04-06T22:29:50Z,5,2,3,0.6,1,4,3,2,"{'LD3': 1, 'LD1': 1, 'LD2': 1}",2,2,"{'LD3': 1, 'LD1': 1, 'LD2': 1}",Bug
1027,1,1,1,2012-04-03T09:28:34Z,2012-04-03T16:45:39Z,1,0,1,1,0,1,0,1,{},0,1,{},
1028,23,0.040421793,4.6,2012-04-03T16:18:51Z,2013-10-24T10:40:57Z,569,564,5,0.008787346,4,7,12,11,"{'LD3': 6, 'LD4': 4, 'LD5': 1, 'LD1': 1}",5,2,"{'LD3': 3, 'LD4': 4, 'LD5': 1, 'LD1': 1}","GUI,Refactoring"
1031,4,0.006896552,4,2012-04-03T22:50:36Z,2013-11-04T14:44:47Z,580,579,1,0.001724138,1,2,1,3,{'LD4': 1},1,1,{'LD4': 1},
1040,2,0.001401542,1,2012-04-05T00:16:29Z,2016-03-01T16:35:06Z,1427,1425,2,0.001401542,2,1,0,2,{},0,1,{},"Docs,Linux/Unix"
1044,6,0.002671416,1.2,2012-04-05T18:14:17Z,2018-05-30T17:46:54Z,2246,2241,5,0.00222618,5,5,1,5,{'LD6': 1},1,4,{'LD6': 1},Bug
1048,3,0.428571429,3,2012-04-05T23:48:42Z,2012-04-12T20:29:30Z,7,6,1,0.142857143,1,2,0,3,{},0,2,{},
1049,4,0.070175439,2,2012-04-06T00:53:51Z,2012-06-01T14:31:07Z,57,55,2,0.035087719,2,2,1,3,{'LD1': 1},1,1,{'LD1': 1},GUI
1053,3,0.5,3,2012-04-06T22:24:04Z,2012-04-12T20:28:33Z,6,5,1,0.166666667,1,2,1,2,{'LD4': 1},1,1,{'LD4': 1},
1056,2,0.333333333,1,2012-04-07T16:28:44Z,2012-04-12T18:36:10Z,6,4,2,0.333333333,2,1,1,1,{'LD2': 1},1,0,{'LD2': 1},
1057,3,0.004807692,1.5,2012-04-07T17:18:36Z,2013-12-22T11:13:43Z,624,622,2,0.003205128,1,2,0,3,{},0,2,{},Bug
1058,1,0.2,1,2012-04-07T21:48:35Z,2012-04-12T20:25:46Z,5,4,1,0.2,1,1,1,0,{'LD4': 1},1,0,{'LD4': 1},
1059,3,0.017964072,1,2012-04-07T23:06:36Z,2012-09-21T12:41:54Z,167,164,3,0.017964072,2,1,3,0,"{'LD4': 1, 'LD5': 2}",1,0,"{'LD4': 1, 'LD5': 1}",
1060,3,0.6,1,2012-04-07T23:07:39Z,2012-04-12T17:24:06Z,5,2,3,0.6,1,2,0,3,{},0,2,{},
1061,5,0.016835017,1.666666667,2012-04-08T18:34:53Z,2013-01-30T11:56:16Z,297,294,3,0.01010101,3,2,2,3,{'LD5': 2},1,1,{'LD5': 1},
1062,3,0.029411765,1.5,2012-04-08T18:49:31Z,2012-07-19T11:36:45Z,102,100,2,0.019607843,3,1,2,1,"{'LD4': 1, 'LD1': 1}",1,0,"{'LD4': 1, 'LD1': 1}","Bug,GUI"
1063,4,0.121212121,2,2012-04-08T19:05:13Z,2012-05-11T06:54:54Z,33,31,2,0.060606061,2,2,2,2,"{'LD4': 1, 'LD3': 1}",2,0,"{'LD4': 1, 'LD3': 1}","Bug,GUI"
1064,11,0.027848101,1.833333333,2012-04-08T19:17:57Z,2013-05-08T06:05:43Z,395,389,6,0.015189873,5,4,4,7,"{'LD3': 1, 'LD4': 1, 'LD1': 1, 'LD5': 1}",3,1,"{'LD3': 1, 'LD4': 1, 'LD1': 1, 'LD5': 1}","Bug,GUI"
1067,4,1.333333333,4,2012-04-09T01:48:24Z,2012-04-11T18:06:36Z,3,2,1,0.333333333,1,3,1,3,{'LD1': 1},1,2,{'LD1': 1},
1069,1,0.2,1,2012-04-09T15:23:35Z,2012-04-14T06:50:23Z,5,4,1,0.2,2,1,0,1,{},0,1,{},Refactoring
1071,15,2.142857143,7.5,2012-04-09T21:20:12Z,2012-04-16T07:55:38Z,7,5,2,0.285714286,2,3,3,12,{'LD4': 3},2,1,{'LD4': 2},"GUI,Refactoring"
1073,2,0.003267974,1,2012-04-10T03:21:43Z,2013-12-12T17:38:38Z,612,610,2,0.003267974,2,2,0,2,{},0,2,{},Bug
1074,7,0.042682927,1.75,2012-04-10T10:53:40Z,2012-09-21T08:46:14Z,164,160,4,0.024390244,3,4,2,5,"{'LD3': 1, 'LD4': 1}",2,2,"{'LD3': 1, 'LD4': 1}","Refactoring,Windows"
1076,2,2,2,2012-04-11T06:09:27Z,2012-04-11T17:55:19Z,1,0,1,1,0,2,0,2,{},0,2,{},
1079,1,0.004464286,1,2012-04-11T13:20:14Z,2012-11-20T14:55:01Z,224,223,1,0.004464286,1,1,1,0,{'LD3': 1},1,0,{'LD3': 1},GUI
1082,7,0.0875,3.5,2012-04-11T17:42:42Z,2012-06-29T18:23:21Z,80,78,2,0.025,3,3,2,5,"{'LD4': 1, 'LD3': 1}",2,1,"{'LD4': 1, 'LD3': 1}",
1085,7,0.018617021,1.4,2012-04-12T23:50:42Z,2013-04-23T23:28:24Z,376,371,5,0.013297872,5,6,1,6,{'LD1': 1},1,5,{'LD1': 1},Refactoring
1098,1,0.5,1,2012-04-14T09:46:29Z,2012-04-15T15:36:53Z,2,1,1,0.5,1,1,0,1,{},0,1,{},
1105,2,0.5,2,2012-04-15T18:21:19Z,2012-04-19T18:13:55Z,4,3,1,0.25,1,2,1,1,{'LD3': 1},1,1,{'LD3': 1},
1107,6,0.08,2,2012-04-15T21:57:23Z,2012-06-29T18:23:07Z,75,72,3,0.04,2,5,2,4,"{'LD4': 1, 'LD5': 1}",2,3,"{'LD4': 1, 'LD5': 1}","Bug,Linux/Unix"
1110,6,0.01980198,1.5,2012-04-16T11:15:08Z,2013-02-12T22:38:29Z,303,299,4,0.01320132,2,3,3,3,"{'LD4': 1, 'LD6': 1, 'LD1': 1}",3,0,"{'LD4': 1, 'LD6': 1, 'LD1': 1}",
1111,4,0.125,1,2012-04-16T11:34:43Z,2012-05-18T08:16:36Z,32,28,4,0.125,4,3,2,2,"{'LD3': 1, 'LD1': 1}",1,2,"{'LD3': 1, 'LD1': 1}",
1116,2,0.012738854,1,2012-04-17T16:33:49Z,2012-09-21T07:41:23Z,157,155,2,0.012738854,2,2,1,1,{'LD3': 1},1,1,{'LD3': 1},
1120,3,0.005385996,1,2012-04-17T22:43:38Z,2013-10-26T07:53:21Z,557,554,3,0.005385996,3,1,1,2,{'LD1': 1},1,0,{'LD1': 1},
1123,1,1,1,2012-04-18T16:35:45Z,2012-04-19T14:37:04Z,1,0,1,1,0,1,1,0,{'LD3': 1},1,0,{'LD3': 1},
1125,1,0.25,1,2012-04-19T18:21:14Z,2012-04-22T22:01:55Z,4,3,1,0.25,1,1,0,1,{},0,1,{},
1127,3,3,3,2012-04-20T00:13:27Z,2012-04-20T16:31:28Z,1,0,1,1,0,1,2,1,"{'LD4': 1, 'LD3': 1}",1,0,"{'LD4': 1, 'LD3': 1}",
1130,2,0.012738854,1,2012-04-21T11:10:59Z,2012-09-25T08:33:24Z,157,155,2,0.012738854,1,2,1,1,{'LD4': 1},1,1,{'LD4': 1},
1132,1,0.002785515,1,2012-04-22T05:29:50Z,2013-04-15T22:08:09Z,359,358,1,0.002785515,1,1,1,0,{'LD3': 1},1,0,{'LD3': 1},
1137,7,0.002389078,1.166666667,2012-04-22T15:15:21Z,2020-04-29T17:24:37Z,2930,2924,6,0.002047782,5,5,2,5,"{'LD4': 1, 'LD3': 1}",2,3,"{'LD4': 1, 'LD3': 1}",GUI
1138,1,0.2,1,2012-04-22T15:39:21Z,2012-04-27T14:09:53Z,5,4,1,0.2,1,1,0,1,{},0,1,{},
1143,4,0.01179941,4,2012-04-24T14:58:10Z,2013-03-29T09:21:23Z,339,338,1,0.002949853,1,3,1,3,{'LD6': 1},1,2,{'LD6': 1},
1144,2,0.083333333,2,2012-04-24T16:19:59Z,2012-05-18T11:25:56Z,24,23,1,0.041666667,1,2,0,2,{},0,2,{},
1147,4,0.034782609,1,2012-04-26T01:12:45Z,2012-08-18T08:53:42Z,115,111,4,0.034782609,2,3,0,4,{},0,3,{},
1148,1,1,1,2012-04-26T01:30:34Z,2012-04-26T14:19:28Z,1,0,1,1,0,1,0,1,{},0,1,{},Bug
1153,3,0.004249292,1,2012-04-27T04:20:02Z,2014-04-02T22:06:35Z,706,703,3,0.004249292,3,3,1,2,{'LD5': 1},1,2,{'LD5': 1},
1154,7,0.194444444,1.4,2012-04-27T14:21:09Z,2012-06-01T14:29:32Z,36,31,5,0.138888889,3,2,2,5,"{'LD4': 1, 'LD1': 1}",2,0,"{'LD4': 1, 'LD1': 1}",
1155,3,0.048387097,1.5,2012-04-27T14:53:59Z,2012-06-27T16:58:42Z,62,60,2,0.032258065,2,3,0,3,{},0,3,{},
1157,1,0.000365764,1,2012-04-28T13:50:39Z,2019-10-22T14:20:55Z,2734,2733,1,0.000365764,1,1,0,1,{},0,1,{},"Brainstorming,P2P"
1161,1,1,1,2012-04-28T21:38:06Z,2012-04-29T01:52:52Z,1,0,1,1,0,1,0,1,{},0,1,{},
1162,5,0.006002401,1.25,2012-04-28T21:51:30Z,2014-08-09T07:06:38Z,833,829,4,0.004801921,4,3,2,3,"{'LD3': 1, 'LD4': 1}",2,1,"{'LD3': 1, 'LD4': 1}",Feature
1164,7,0.009408602,1.166666667,2012-04-29T19:22:42Z,2014-05-13T07:19:26Z,744,738,6,0.008064516,5,5,4,3,"{'LD4': 3, 'LD1': 1}",4,1,"{'LD4': 3, 'LD1': 1}",Wallet
1165,1,0.009009009,1,2012-04-29T22:10:42Z,2012-08-18T14:37:58Z,111,110,1,0.009009009,2,1,0,1,{},0,1,{},
1169,3,1,3,2012-04-30T16:08:54Z,2012-05-03T06:09:31Z,3,2,1,0.333333333,1,2,1,2,{'LD4': 1},1,1,{'LD4': 1},
1181,3,0.025641026,1.5,2012-05-02T08:31:56Z,2012-08-27T04:17:40Z,117,115,2,0.017094017,2,2,1,2,{'LD3': 1},1,1,{'LD3': 1},
1182,4,0.093023256,1,2012-05-02T14:03:16Z,2012-06-14T06:13:37Z,43,39,4,0.093023256,3,2,4,0,"{'LD4': 1, 'LD1': 1, 'LD2': 2}",2,0,"{'LD4': 1, 'LD1': 1, 'LD2': 2}",
1183,4,0.012084592,1.333333333,2012-05-02T17:26:32Z,2013-03-29T09:41:01Z,331,328,3,0.009063444,3,2,1,3,{'LD4': 1},1,1,{'LD4': 1},GUI
1184,3,0.00270027,1.5,2012-05-02T18:32:56Z,2015-05-18T10:36:20Z,1111,1109,2,0.00180018,2,2,1,2,{'LD3': 1},1,1,{'LD3': 1},
1185,2,0.003003003,2,2012-05-02T18:55:47Z,2014-02-27T03:22:37Z,666,665,1,0.001501502,1,2,0,2,{},0,2,{},
1186,3,1.5,3,2012-05-02T22:48:52Z,2012-05-04T17:21:05Z,2,1,1,0.5,1,3,2,1,"{'LD1': 1, 'LD2': 1}",2,1,"{'LD1': 1, 'LD2': 1}",
1190,3,1,1.5,2012-05-03T17:51:13Z,2012-05-06T15:51:45Z,3,1,2,0.666666667,1,2,2,1,"{'LD3': 1, 'LD5': 1}",2,0,"{'LD3': 1, 'LD5': 1}",
1191,4,4,4,2012-05-03T18:40:39Z,2012-05-04T12:44:22Z,1,0,1,1,0,4,1,3,{'LD2': 1},1,3,{'LD2': 1},
1192,1,1,1,2012-05-03T22:54:42Z,2012-05-03T23:20:01Z,1,0,1,1,0,1,0,1,{},0,1,{},
1195,2,0.001221747,1,2012-05-04T22:53:05Z,2016-10-27T10:59:30Z,1637,1635,2,0.001221747,3,2,2,0,"{'LD2': 1, 'LD4': 1}",2,0,"{'LD2': 1, 'LD4': 1}","P2P,Resource usage"
1210,1,1,1,2012-05-06T12:31:30Z,2012-05-06T15:10:19Z,1,0,1,1,0,1,0,1,{},0,1,{},
1213,5,0.00363901,1.666666667,2012-05-06T23:43:02Z,2016-02-09T16:21:12Z,1374,1371,3,0.002183406,3,3,1,4,{'LD4': 1},1,2,{'LD4': 1},Tests
1218,1,1,1,2012-05-07T18:54:38Z,2012-05-07T19:36:45Z,1,0,1,1,0,1,1,0,{'LD3': 1},1,0,{'LD3': 1},
1222,6,0.018461538,2,2012-05-08T10:37:26Z,2013-03-29T09:37:39Z,325,322,3,0.009230769,2,2,2,4,"{'LD1': 1, 'LD3': 1}",2,0,"{'LD1': 1, 'LD3': 1}","GUI,Refactoring"
1224,2,0.007490637,1,2012-05-08T19:38:42Z,2013-01-30T02:46:16Z,267,265,2,0.007490637,3,2,0,2,{},0,2,{},Refactoring
1227,11,0.091666667,2.2,2012-05-08T21:43:56Z,2012-09-05T15:51:49Z,120,115,5,0.041666667,6,3,1,10,{'LD4': 1},1,2,{'LD4': 1},
1228,7,3.5,3.5,2012-05-08T21:52:09Z,2012-05-10T17:03:40Z,2,0,2,1,0,2,2,5,"{'LD3': 1, 'LD5': 1}",1,1,"{'LD3': 1, 'LD5': 1}",
1229,3,3,3,2012-05-09T00:23:13Z,2012-05-09T05:26:38Z,1,0,1,1,0,3,1,2,{'LD1': 1},1,2,{'LD1': 1},
1231,3,0.004901961,1,2012-05-09T04:22:08Z,2014-01-10T12:20:42Z,612,609,3,0.004901961,3,3,2,1,"{'LD4': 1, 'LD3': 1}",2,1,"{'LD4': 1, 'LD3': 1}","Bug,GUI"
1234,3,0.008571429,1.5,2012-05-09T10:39:23Z,2013-04-23T23:27:33Z,350,348,2,0.005714286,3,1,0,3,{},0,1,{},Bug
1236,10,0.074074074,1.666666667,2012-05-09T10:43:04Z,2012-09-21T08:55:35Z,135,129,6,0.044444444,3,3,2,8,{'LD3': 2},1,2,{'LD3': 1},
1242,48,0.07804878,2.285714286,2012-05-09T14:04:09Z,2014-01-13T17:36:18Z,615,594,21,0.034146341,15,14,22,26,"{'LD3': 10, 'LD1': 4, 'LD4': 6, 'LD2': 2}",9,5,"{'LD3': 8, 'LD1': 2, 'LD4': 3, 'LD2': 2}","GUI,Linux/Unix"
1244,1,0.5,1,2012-05-09T16:25:45Z,2012-05-11T09:22:35Z,2,1,1,0.5,1,1,1,0,{'LD6': 1},1,0,{'LD6': 1},"Feature,GUI"
1248,2,1,2,2012-05-09T20:58:33Z,2012-05-11T13:51:06Z,2,1,1,0.5,1,1,0,2,{},0,1,{},
1249,2,0.4,2,2012-05-10T10:29:59Z,2012-05-14T20:48:09Z,5,4,1,0.2,1,1,0,2,{},0,1,{},
1253,4,0.029850746,1.333333333,2012-05-10T21:19:27Z,2012-09-21T08:19:33Z,134,131,3,0.02238806,2,3,1,3,{'LD4': 1},1,2,{'LD4': 1},
1256,1,1,1,2012-05-11T07:01:20Z,2012-05-11T08:20:05Z,1,0,1,1,0,1,0,1,{},0,1,{},
1273,1,0.003115265,1,2012-05-12T20:12:49Z,2013-03-29T09:45:07Z,321,320,1,0.003115265,1,1,0,1,{},0,1,{},Feature
1276,2,1,2,2012-05-12T22:27:13Z,2012-05-14T21:36:00Z,2,1,1,0.5,1,1,2,0,"{'LD2': 1, 'LD3': 1}",1,0,"{'LD2': 1, 'LD3': 1}",
1278,3,1,3,2012-05-12T23:17:49Z,2012-05-15T06:40:53Z,3,2,1,0.333333333,1,3,1,2,{'LD3': 1},1,2,{'LD3': 1},
1279,1,0.001154734,1,2012-05-12T23:33:53Z,2014-09-25T10:15:35Z,866,865,1,0.001154734,1,1,0,1,{},0,1,{},"Feature,GUI"
1280,1,0.5,1,2012-05-13T00:08:57Z,2012-05-14T10:12:36Z,2,1,1,0.5,1,1,1,0,{'LD3': 1},1,0,{'LD3': 1},
1290,3,3,3,2012-05-13T20:08:35Z,2012-05-13T20:32:58Z,1,0,1,1,0,2,0,3,{},0,2,{},
1294,1,1,1,2012-05-14T04:05:54Z,2012-05-14T13:48:39Z,1,0,1,1,0,1,0,1,{},0,1,{},
1310,1,0.018867925,1,2012-05-14T22:00:58Z,2012-07-06T00:11:47Z,53,52,1,0.018867925,1,1,1,0,{'LD4': 1},1,0,{'LD4': 1},
1317,5,0.052631579,5,2012-05-15T18:34:04Z,2012-08-18T09:25:50Z,95,94,1,0.010526316,1,1,0,5,{},0,1,{},
1320,1,0.071428571,1,2012-05-15T23:21:15Z,2012-05-29T18:09:49Z,14,13,1,0.071428571,1,1,0,1,{},0,1,{},
1325,8,1.6,8,2012-05-16T20:39:56Z,2012-05-21T16:54:59Z,5,4,1,0.2,1,2,0,8,{},0,2,{},
1327,7,1,1.75,2012-05-17T07:07:21Z,2012-05-23T15:51:00Z,7,3,4,0.571428571,1,3,4,3,"{'LD4': 2, 'LD3': 2}",3,0,"{'LD4': 2, 'LD3': 2}",
1356,6,0.15,1.5,2012-05-18T19:32:46Z,2012-06-27T16:36:02Z,40,36,4,0.1,2,3,2,4,"{'LD4': 1, 'LD5': 1}",2,1,"{'LD4': 1, 'LD5': 1}",
1361,1,0.003184713,1,2012-05-19T09:42:21Z,2013-03-29T09:35:01Z,314,313,1,0.003184713,1,1,0,1,{},0,1,{},"GUI,Refactoring"
1371,1,1,1,2012-05-21T22:05:11Z,2012-05-22T14:53:43Z,1,0,1,1,0,1,1,0,{'LD4': 1},1,0,{'LD4': 1},"Bug,macOS"
1373,1,0.022222222,1,2012-05-22T00:44:56Z,2012-07-05T22:18:49Z,45,44,1,0.022222222,2,1,0,1,{},0,1,{},
1384,7,0.056451613,2.333333333,2012-05-24T02:19:29Z,2012-09-24T05:25:57Z,124,121,3,0.024193548,3,3,6,1,"{'LD3': 5, 'LD4': 1}",3,0,"{'LD3': 2, 'LD4': 1}","GUI,Refactoring"
1385,3,0.002228826,1.5,2012-05-24T03:11:59Z,2016-01-29T13:00:29Z,1346,1344,2,0.001485884,2,3,0,3,{},0,3,{},
1390,1,0.023809524,1,2012-05-25T03:00:40Z,2012-07-05T22:16:22Z,42,41,1,0.023809524,1,1,0,1,{},0,1,{},
1391,2,2,2,2012-05-25T11:02:18Z,2012-05-25T15:48:34Z,1,0,1,1,0,2,1,1,{'LD5': 1},1,1,{'LD5': 1},
1397,1,0.5,1,2012-05-29T20:44:21Z,2012-05-31T04:59:43Z,2,1,1,0.5,1,1,0,1,{},0,1,{},
1400,2,0.055555556,2,2012-05-31T00:18:37Z,2012-07-05T22:14:10Z,36,35,1,0.027777778,1,2,1,1,{'LD5': 1},1,1,{'LD5': 1},
1401,54,0.043096568,3.6,2012-05-31T02:49:20Z,2015-11-04T11:08:29Z,1253,1238,15,0.011971269,12,7,16,38,"{'LD3': 3, 'LD4': 10, 'LD1': 3}",5,2,"{'LD3': 3, 'LD4': 3, 'LD1': 2}","Docs,Windows"
1402,2,0.055555556,2,2012-05-31T07:25:42Z,2012-07-05T22:12:56Z,36,35,1,0.027777778,1,2,0,2,{},0,2,{},
1407,1,0.008849558,1,2012-05-31T23:41:03Z,2012-09-21T08:34:13Z,113,112,1,0.008849558,2,1,0,1,{},0,1,{},
1414,2,0.05,1,2012-06-03T15:43:37Z,2012-07-13T03:29:26Z,40,38,2,0.05,3,1,0,2,{},0,1,{},Bug
1419,3,0.130434783,1.5,2012-06-05T00:07:34Z,2012-06-27T16:35:34Z,23,21,2,0.086956522,2,2,1,2,{'LD2': 1},1,1,{'LD2': 1},
1428,1,0.001189061,1,2012-06-06T19:40:11Z,2014-09-25T10:19:47Z,841,840,1,0.001189061,1,1,0,1,{},0,1,{},
1430,1,0.013888889,1,2012-06-07T22:58:30Z,2012-08-18T14:33:25Z,72,71,1,0.013888889,1,1,1,0,{'LD3': 1},1,0,{'LD3': 1},
1432,11,0.154929577,1.571428571,2012-06-08T17:46:21Z,2012-08-18T08:15:31Z,71,64,7,0.098591549,6,2,6,5,"{'LD3': 2, 'LD4': 2, 'LD1': 1, 'LD5': 1}",2,0,"{'LD3': 1, 'LD4': 1, 'LD1': 1, 'LD5': 1}",
1436,1,0.001140251,1,2012-06-09T21:49:07Z,2014-11-03T07:49:33Z,877,876,1,0.001140251,2,1,0,1,{},0,1,{},Bug
1438,4,0.00776699,1.333333333,2012-06-10T21:03:05Z,2013-11-07T12:05:21Z,515,512,3,0.005825243,3,4,2,2,"{'LD4': 1, 'LD5': 1}",2,2,"{'LD4': 1, 'LD5': 1}",
1442,2,1,2,2012-06-12T06:40:52Z,2012-06-14T01:19:55Z,2,1,1,0.5,1,2,0,2,{},0,2,{},
1447,3,0.008241758,1.5,2012-06-13T14:54:51Z,2013-06-12T14:34:29Z,364,362,2,0.005494505,1,3,3,0,"{'LD4': 2, 'LD5': 1}",3,0,"{'LD4': 2, 'LD5': 1}",
1450,3,0.010380623,1.5,2012-06-13T16:38:49Z,2013-03-29T09:34:16Z,289,287,2,0.006920415,2,2,2,1,{'LD4': 2},1,1,{'LD4': 1},
1452,5,0.166666667,1.25,2012-06-13T16:43:24Z,2012-07-13T11:45:55Z,30,26,4,0.133333333,3,1,1,4,{'LD4': 1},1,0,{'LD4': 1},
1454,1,1,1,2012-06-13T22:34:54Z,2012-06-14T06:14:20Z,1,0,1,1,0,1,0,1,{},0,1,{},
1457,1,0.2,1,2012-06-14T02:40:33Z,2012-06-18T13:59:03Z,5,4,1,0.2,2,1,0,1,{},0,1,{},
1460,3,0.005802708,3,2012-06-14T07:04:26Z,2013-11-12T16:26:38Z,517,516,1,0.001934236,1,2,0,3,{},0,2,{},
1462,4,0.055555556,4,2012-06-14T13:57:05Z,2012-08-24T20:00:34Z,72,71,1,0.013888889,1,2,0,4,{},0,2,{},
1466,2,0.004024145,1,2012-06-14T17:45:10Z,2013-10-24T10:42:54Z,497,495,2,0.004024145,3,2,0,2,{},0,2,{},
1467,2,0.00104712,1,2012-06-14T23:55:53Z,2017-09-06T00:42:44Z,1910,1908,2,0.00104712,3,2,0,2,{},0,2,{},P2P
1468,1,0.009615385,1,2012-06-15T00:52:39Z,2012-09-26T11:04:35Z,104,103,1,0.009615385,1,1,0,1,{},0,1,{},
1472,2,0.020408163,2,2012-06-16T00:36:57Z,2012-09-21T09:13:38Z,98,97,1,0.010204082,1,2,1,1,{'LD4': 1},1,1,{'LD4': 1},
1473,1,0.001477105,1,2012-06-16T02:51:25Z,2014-04-23T14:36:35Z,677,676,1,0.001477105,1,1,0,1,{},0,1,{},"Feature,Linux/Unix"
1474,4,0.2,2,2012-06-16T15:42:58Z,2012-07-05T19:20:05Z,20,18,2,0.1,2,2,0,4,{},0,2,{},
1482,3,0.333333333,1.5,2012-06-18T17:06:40Z,2012-06-27T16:35:12Z,9,7,2,0.222222222,2,1,3,0,"{'LD3': 1, 'LD4': 1, 'LD5': 1}",1,0,"{'LD3': 1, 'LD4': 1, 'LD5': 1}",
1491,2,0.003294893,2,2012-06-20T18:14:10Z,2014-02-17T14:25:20Z,607,606,1,0.001647446,1,1,0,2,{},0,1,{},"Bug,GUI"
1492,1,0.00462963,1,2012-06-20T18:54:17Z,2013-01-21T21:53:40Z,216,215,1,0.00462963,2,1,0,1,{},0,1,{},"Bug,macOS"
1505,5,0.008561644,1.25,2012-06-22T20:51:25Z,2014-01-27T10:57:00Z,584,580,4,0.006849315,3,3,3,2,{'LD3': 3},2,1,{'LD3': 2},Bug
1506,6,0.3,2,2012-06-23T06:12:46Z,2012-07-13T05:51:29Z,20,17,3,0.15,1,1,2,4,"{'LD1': 1, 'LD5': 1}",1,0,"{'LD1': 1, 'LD5': 1}",GUI
1509,9,0.375,2.25,2012-06-23T17:46:49Z,2012-07-17T06:20:07Z,24,20,4,0.166666667,3,2,5,4,"{'LD5': 1, 'LD4': 1, 'LD1': 2, 'LD3': 1}",2,0,"{'LD5': 1, 'LD4': 1, 'LD1': 1, 'LD3': 1}","GUI,Refactoring"
1513,2,0.004008016,1,2012-06-24T10:37:54Z,2013-11-04T14:58:48Z,499,497,2,0.004008016,3,2,1,1,{'LD1': 1},1,1,{'LD1': 1},Bug
1522,22,0.071895425,1.833333333,2012-06-26T08:19:23Z,2013-04-27T09:15:57Z,306,294,12,0.039215686,9,6,7,15,"{'LD4': 2, 'LD3': 3, 'LD5': 1, 'LD6': 1}",5,1,"{'LD4': 2, 'LD3': 2, 'LD5': 1, 'LD6': 1}","Bug,GUI,macOS"
1524,1,0.5,1,2012-06-27T18:00:40Z,2012-06-29T00:14:59Z,2,1,1,0.5,1,1,0,1,{},0,1,{},
1527,1,0.002415459,1,2012-06-28T01:17:02Z,2013-08-15T22:35:09Z,414,413,1,0.002415459,1,1,1,0,{'LD5': 1},1,0,{'LD5': 1},Refactoring
1528,2,2,2,2012-06-28T02:38:27Z,2012-06-28T12:21:11Z,1,0,1,1,0,2,0,2,{},0,2,{},
1534,2,2,2,2012-06-29T15:59:06Z,2012-06-29T22:22:53Z,1,0,1,1,0,1,1,1,{'LD1': 1},1,0,{'LD1': 1},
1535,4,0.002012072,1,2012-06-29T16:49:43Z,2017-12-08T02:12:18Z,1988,1984,4,0.002012072,2,3,2,2,"{'LD1': 1, 'LD4': 1}",2,1,"{'LD1': 1, 'LD4': 1}",Bug
1541,1,0.25,1,2012-06-30T13:52:34Z,2012-07-04T02:50:08Z,4,3,1,0.25,1,1,0,1,{},0,1,{},
1547,1,0.012195122,1,2012-07-02T01:15:55Z,2012-09-21T08:04:35Z,82,81,1,0.012195122,1,1,1,0,{'LD4': 1},1,0,{'LD4': 1},Bug
1558,1,0.019607843,1,2012-07-05T07:04:17Z,2012-08-24T10:08:10Z,51,50,1,0.019607843,2,1,1,0,{'LD4': 1},1,0,{'LD4': 1},Bug
1568,2,0.004219409,2,2012-07-08T01:57:10Z,2013-10-24T10:49:29Z,474,473,1,0.002109705,1,2,1,1,{'LD3': 1},1,1,{'LD3': 1},GUI
1570,5,0.006640106,2.5,2012-07-08T17:04:46Z,2014-07-31T08:12:59Z,753,751,2,0.002656042,2,2,2,3,"{'LD1': 1, 'LD4': 1}",2,0,"{'LD1': 1, 'LD4': 1}","GUI,Refactoring,TX fees and policy"
1573,2,0.009950249,2,2012-07-09T20:43:50Z,2013-01-26T01:07:54Z,201,200,1,0.004975124,1,1,1,1,{'LD2': 1},1,0,{'LD2': 1},
1576,2,0.090909091,1,2012-07-10T19:32:05Z,2012-08-01T07:33:25Z,22,20,2,0.090909091,1,2,1,1,{'LD1': 1},1,1,{'LD1': 1},
1578,1,1,1,2012-07-11T01:18:03Z,2012-07-11T01:33:05Z,1,0,1,1,0,1,0,1,{},0,1,{},
1579,2,0.027777778,2,2012-07-11T08:44:46Z,2012-09-21T07:25:24Z,72,71,1,0.013888889,1,2,1,1,{'LD3': 1},1,1,{'LD3': 1},
1588,1,0.2,1,2012-07-12T13:06:12Z,2012-07-17T12:58:04Z,5,4,1,0.2,1,1,0,1,{},0,1,{},
1599,2,0.011428571,1,2012-07-16T12:04:39Z,2013-01-06T16:10:15Z,175,173,2,0.011428571,3,2,0,2,{},0,2,{},Bug
1600,2,1,2,2012-07-16T17:56:02Z,2012-07-18T14:16:45Z,2,1,1,0.5,1,1,1,1,{'LD4': 1},1,0,{'LD4': 1},
1601,4,2,4,2012-07-16T17:59:07Z,2012-07-18T06:00:40Z,2,1,1,0.5,1,2,1,3,{'LD3': 1},1,1,{'LD3': 1},
1602,2,1,1,2012-07-16T21:15:59Z,2012-07-18T14:16:17Z,2,0,2,1,0,2,1,1,{'LD4': 1},1,1,{'LD4': 1},
1613,3,0.004115226,1,2012-07-20T05:15:18Z,2014-07-18T10:57:16Z,729,726,3,0.004115226,4,2,0,3,{},0,2,{},Feature
1618,4,0.015936255,4,2012-07-21T18:07:06Z,2013-03-29T09:46:49Z,251,250,1,0.003984064,1,2,3,1,"{'LD1': 2, 'LD4': 1}",1,1,"{'LD1': 1, 'LD4': 1}",
1625,4,0.006884682,4,2012-07-23T17:41:19Z,2014-02-24T14:04:19Z,581,580,1,0.00172117,1,1,2,2,"{'LD4': 1, 'LD1': 1}",1,0,"{'LD4': 1, 'LD1': 1}",Bug
1626,4,0.363636364,4,2012-07-23T21:57:42Z,2012-08-03T02:19:53Z,11,10,1,0.090909091,1,2,2,2,{'LD1': 2},2,0,{'LD1': 2},
1627,1,0.090909091,1,2012-07-23T22:06:44Z,2012-08-03T02:18:39Z,11,10,1,0.090909091,1,1,0,1,{},0,1,{},
1629,3,0.005172414,1.5,2012-07-24T10:34:41Z,2014-02-24T08:54:56Z,580,578,2,0.003448276,2,2,0,3,{},0,2,{},
1637,2,0.002257336,1,2012-07-29T06:07:23Z,2014-12-31T14:12:31Z,886,884,2,0.002257336,3,2,1,1,{'LD4': 1},1,1,{'LD4': 1},Wallet
1643,4,0.001416431,1.333333333,2012-08-01T19:47:01Z,2020-04-24T20:00:58Z,2824,2821,3,0.001062323,4,4,0,4,{},0,4,{},"TX fees and policy,Wallet"
1653,4,0.001296596,1.333333333,2012-08-06T01:48:40Z,2021-01-15T19:14:11Z,3085,3082,3,0.000972447,3,4,1,3,{'LD3': 1},1,3,{'LD3': 1},"Feature,Wallet"
1656,4,0.093023256,1.333333333,2012-08-06T15:22:52Z,2012-09-18T11:59:41Z,43,40,3,0.069767442,3,2,2,2,"{'LD3': 1, 'LD5': 1}",1,1,"{'LD3': 1, 'LD5': 1}",
1659,2,0.285714286,1,2012-08-07T10:28:15Z,2012-08-13T20:40:38Z,7,5,2,0.285714286,1,2,1,1,{'LD3': 1},1,1,{'LD3': 1},
1662,3,0.004559271,1.5,2012-08-08T16:24:34Z,2014-05-28T07:09:53Z,658,656,2,0.003039514,2,3,1,2,{'LD3': 1},1,2,{'LD3': 1},"Refactoring,Wallet"
1663,1,0.001769912,1,2012-08-08T17:47:09Z,2014-02-24T08:43:10Z,565,564,1,0.001769912,2,1,0,1,{},0,1,{},Bug
1664,7,0.015765766,1.4,2012-08-09T01:00:09Z,2013-10-26T08:02:54Z,444,439,5,0.011261261,4,4,3,4,"{'LD3': 1, 'LD4': 2}",2,2,"{'LD3': 1, 'LD4': 1}",
1665,5,0.010845987,5,2012-08-09T06:48:10Z,2013-11-12T15:45:01Z,461,460,1,0.002169197,1,3,2,3,"{'LD3': 1, 'LD1': 1}",2,1,"{'LD3': 1, 'LD1': 1}",Feature
1667,1,0.111111111,1,2012-08-10T04:59:48Z,2012-08-18T08:28:40Z,9,8,1,0.111111111,1,1,1,0,{'LD5': 1},1,0,{'LD5': 1},
1669,5,0.555555556,5,2012-08-13T06:04:14Z,2012-08-21T17:57:06Z,9,8,1,0.111111111,1,3,2,3,{'LD3': 2},1,2,{'LD3': 1},
1675,5,0.002483855,1,2012-08-14T20:52:51Z,2018-02-16T23:32:37Z,2013,2008,5,0.002483855,4,5,3,2,"{'LD4': 1, 'LD5': 2}",3,2,"{'LD4': 1, 'LD5': 2}",Brainstorming
1676,1,0.004444444,1,2012-08-16T13:35:15Z,2013-03-29T09:46:25Z,225,224,1,0.004444444,1,1,0,1,{},0,1,{},
1682,1,0.004464286,1,2012-08-17T18:22:18Z,2013-03-29T10:09:24Z,224,223,1,0.004464286,1,1,1,0,{'LD4': 1},1,0,{'LD4': 1},
1703,1,0.002262443,1,2012-08-23T06:36:59Z,2013-11-07T12:12:40Z,442,441,1,0.002262443,1,1,0,1,{},0,1,{},
1704,1,0.000861326,1,2012-08-23T09:44:39Z,2015-10-27T11:26:42Z,1161,1160,1,0.000861326,2,1,0,1,{},0,1,{},Brainstorming
1711,2,0.008196721,1,2012-08-23T13:57:32Z,2013-04-23T23:23:06Z,244,242,2,0.008196721,1,2,1,1,{'LD3': 1},1,1,{'LD3': 1},
1712,2,0.071428571,2,2012-08-23T13:58:38Z,2012-09-20T07:42:48Z,28,27,1,0.035714286,1,1,0,2,{},0,1,{},
1714,16,0.039312039,1.777777778,2012-08-24T00:16:25Z,2013-10-04T09:26:43Z,407,398,9,0.022113022,6,5,4,12,"{'LD3': 2, 'LD1': 1, 'LD5': 1}",2,3,"{'LD3': 1, 'LD1': 1, 'LD5': 1}","Bug,GUI"
1715,6,0.013605442,2,2012-08-24T00:18:49Z,2013-11-07T12:11:41Z,441,438,3,0.006802721,4,3,1,5,{'LD4': 1},1,2,{'LD4': 1},Bug
1719,2,0.007142857,2,2012-08-24T10:47:15Z,2013-05-30T13:38:00Z,280,279,1,0.003571429,1,2,1,1,{'LD6': 1},1,1,{'LD6': 1},
1722,5,0.012755102,1.666666667,2012-08-24T12:31:56Z,2013-09-20T00:10:08Z,392,389,3,0.007653061,1,3,0,5,{},0,3,{},
1725,3,0.004643963,1.5,2012-08-26T08:17:27Z,2014-06-02T13:12:23Z,646,644,2,0.003095975,2,2,1,2,{'LD4': 1},1,1,{'LD4': 1},"Bug,GUI"
1727,2,0.076923077,1,2012-08-27T04:31:24Z,2012-09-21T07:56:51Z,26,24,2,0.076923077,2,2,0,2,{},0,2,{},
1734,3,0.004862237,1.5,2012-08-28T04:48:42Z,2014-05-06T14:37:07Z,617,615,2,0.003241491,2,3,0,3,{},0,3,{},Refactoring
1737,1,0.045454545,1,2012-08-28T15:21:31Z,2012-09-18T23:27:09Z,22,21,1,0.045454545,1,1,0,1,{},0,1,{},
1746,10,0.013192612,3.333333333,2012-08-28T22:23:48Z,2014-09-25T10:07:33Z,758,755,3,0.003957784,3,3,3,7,"{'LD4': 2, 'LD1': 1}",3,0,"{'LD4': 2, 'LD1': 1}","Feature,Wallet"
1747,2,0.004716981,1,2012-08-28T23:05:34Z,2013-10-26T07:57:05Z,424,422,2,0.004716981,1,2,2,0,{'LD3': 2},2,0,{'LD3': 2},
1750,7,0.875,7,2012-08-29T04:24:19Z,2012-09-05T15:45:14Z,8,7,1,0.125,1,2,2,5,{'LD4': 2},1,1,{'LD4': 1},
1753,3,0.142857143,3,2012-08-29T15:56:27Z,2012-09-18T23:26:53Z,21,20,1,0.047619048,1,2,0,3,{},0,2,{},
1759,8,0.054794521,4,2012-08-30T20:18:57Z,2013-01-23T16:07:38Z,146,144,2,0.01369863,2,6,2,6,"{'LD1': 1, 'LD3': 1}",1,5,"{'LD1': 1, 'LD3': 1}",Bug
1763,1,0.002008032,1,2012-08-31T05:16:36Z,2014-01-10T12:17:46Z,498,497,1,0.002008032,2,1,1,0,{'LD4': 1},1,0,{'LD4': 1},Bug
1765,5,5,5,2012-08-31T05:39:10Z,2012-08-31T07:25:10Z,1,0,1,1,0,2,2,3,"{'LD4': 1, 'LD5': 1}",1,1,"{'LD4': 1, 'LD5': 1}",
1766,1,0.001663894,1,2012-08-31T07:19:50Z,2014-04-23T14:16:26Z,601,600,1,0.001663894,2,1,1,0,{'LD3': 1},1,0,{'LD3': 1},GUI
1768,3,0.6,1,2012-08-31T18:18:22Z,2012-09-05T15:44:44Z,5,2,3,0.6,2,3,0,3,{},0,3,{},Bug
1773,2,0.008064516,1,2012-09-01T20:48:50Z,2013-05-07T20:14:16Z,248,246,2,0.008064516,3,2,0,2,{},0,2,{},Bug
1775,7,0.025735294,1.75,2012-09-02T06:17:00Z,2013-05-31T12:07:46Z,272,268,4,0.014705882,4,1,1,6,{'LD1': 1},1,0,{'LD1': 1},GUI
1776,5,0.065789474,1.25,2012-09-02T22:18:06Z,2012-11-17T13:30:10Z,76,72,4,0.052631579,3,2,3,2,"{'LD3': 1, 'LD4': 1, 'LD5': 1}",2,0,"{'LD3': 1, 'LD4': 1, 'LD5': 1}","Bug,GUI"
1783,2,2,2,2012-09-04T00:06:01Z,2012-09-04T22:36:30Z,1,0,1,1,0,2,2,0,"{'LD4': 1, 'LD1': 1}",2,0,"{'LD4': 1, 'LD1': 1}",
1797,5,5,5,2012-09-07T08:08:31Z,2012-09-07T13:25:45Z,1,0,1,1,0,3,1,4,{'LD1': 1},1,2,{'LD1': 1},
1801,1,0.002040816,1,2012-09-08T11:22:29Z,2014-01-10T15:21:10Z,490,489,1,0.002040816,2,1,1,0,{'LD4': 1},1,0,{'LD4': 1},Bug
1805,3,3,3,2012-09-09T06:39:34Z,2012-09-09T08:51:22Z,1,0,1,1,0,2,0,3,{},0,2,{},
1806,4,0.333333333,2,2012-09-09T09:14:53Z,2012-09-21T08:06:22Z,12,10,2,0.166666667,1,2,1,3,{'LD5': 1},1,1,{'LD5': 1},
1817,2,0.009950249,2,2012-09-10T05:16:53Z,2013-03-29T10:04:47Z,201,200,1,0.004975124,1,1,2,0,"{'LD1': 1, 'LD3': 1}",1,0,"{'LD1': 1, 'LD3': 1}",
1820,1,1,1,2012-09-12T01:17:05Z,2012-09-12T12:46:21Z,1,0,1,1,0,1,0,1,{},0,1,{},Bug
1824,2,0.027777778,1,2012-09-14T18:56:59Z,2012-11-25T01:29:59Z,72,70,2,0.027777778,3,2,0,2,{},0,2,{},Bug
1826,1,1,1,2012-09-16T11:29:35Z,2012-09-16T12:06:14Z,1,0,1,1,0,1,1,0,{'LD1': 1},1,0,{'LD1': 1},
1827,2,0.003311258,1,2012-09-16T11:39:01Z,2014-05-13T06:09:33Z,604,602,2,0.003311258,3,1,1,1,{'LD3': 1},1,0,{'LD3': 1},Refactoring
1831,3,0.023809524,3,2012-09-18T16:52:07Z,2013-01-21T21:55:07Z,126,125,1,0.007936508,1,1,2,1,"{'LD3': 1, 'LD4': 1}",1,0,"{'LD3': 1, 'LD4': 1}","GUI,Refactoring"
1832,3,0.026086957,1.5,2012-09-18T21:48:59Z,2013-01-11T16:13:10Z,115,113,2,0.017391304,2,2,2,1,"{'LD3': 1, 'LD4': 1}",2,0,"{'LD3': 1, 'LD4': 1}",Bug
1838,1,1,1,2012-09-19T04:49:34Z,2012-09-20T03:49:28Z,1,0,1,1,0,1,0,1,{},0,1,{},
1839,6,0.045801527,1,2012-09-19T18:00:19Z,2013-01-28T17:28:35Z,131,125,6,0.045801527,5,4,5,1,"{'LD4': 1, 'LD3': 2, 'LD6': 1, 'LD5': 1}",4,0,"{'LD4': 1, 'LD3': 2, 'LD6': 1, 'LD5': 1}","Bug,GUI"
1840,9,0.081081081,4.5,2012-09-20T09:44:23Z,2013-01-09T08:16:42Z,111,109,2,0.018018018,1,3,2,7,"{'LD1': 1, 'LD5': 1}",2,1,"{'LD1': 1, 'LD5': 1}","GUI,Refactoring"
1841,4,4,4,2012-09-20T11:02:35Z,2012-09-20T14:30:23Z,1,0,1,1,0,3,1,3,{'LD3': 1},1,2,{'LD3': 1},
1842,1,0.083333333,1,2012-09-20T19:46:33Z,2012-10-01T21:03:25Z,12,11,1,0.083333333,1,1,0,1,{},0,1,{},
1843,1,1,1,2012-09-21T17:06:37Z,2012-09-21T19:59:32Z,1,0,1,1,0,1,0,1,{},0,1,{},
1846,2,0.005291005,1,2012-09-21T17:45:51Z,2013-10-04T08:47:24Z,378,376,2,0.005291005,2,2,1,1,{'LD1': 1},1,1,{'LD1': 1},Refactoring
1855,1,0.002427184,1,2012-09-22T10:29:58Z,2013-11-07T12:08:44Z,412,411,1,0.002427184,2,1,1,0,{'LD3': 1},1,0,{'LD3': 1},
1858,5,0.004424779,5,2012-09-23T02:05:33Z,2015-10-27T11:25:24Z,1130,1129,1,0.000884956,1,3,1,4,{'LD3': 1},1,2,{'LD3': 1},"GUI,Refactoring"
1865,7,0.01686747,7,2012-09-25T00:30:10Z,2013-11-13T16:25:27Z,415,414,1,0.002409639,1,4,3,4,"{'LD3': 2, 'LD4': 1}",3,1,"{'LD3': 2, 'LD4': 1}","Docs,Refactoring"
1873,2,0.002747253,1,2012-09-27T17:45:15Z,2014-09-25T10:06:09Z,728,726,2,0.002747253,2,2,1,1,{'LD1': 1},1,1,{'LD1': 1},Bug
1877,4,0.16,2,2012-09-27T21:05:48Z,2012-10-22T02:24:35Z,25,23,2,0.08,1,2,1,3,{'LD3': 1},1,1,{'LD3': 1},"Bug,GUI,Windows"
1882,1,0.002557545,1,2012-09-28T15:16:25Z,2013-10-24T10:46:06Z,391,390,1,0.002557545,1,1,0,1,{},0,1,{},
1884,13,1.444444444,4.333333333,2012-09-28T21:24:34Z,2012-10-07T19:44:56Z,9,6,3,0.333333333,1,4,5,8,"{'LD1': 1, 'LD6': 2, 'LD4': 1, 'LD5': 1}",4,0,"{'LD1': 1, 'LD6': 2, 'LD4': 1, 'LD5': 1}","GUI,Wallet"
1887,2,0.005154639,2,2012-09-29T12:34:58Z,2013-10-22T08:20:36Z,388,387,1,0.00257732,2,2,1,1,{'LD3': 1},1,1,{'LD3': 1},
1894,5,0.010706638,1.666666667,2012-09-30T20:09:44Z,2014-01-10T12:16:38Z,467,464,3,0.006423983,2,4,2,3,"{'LD4': 1, 'LD3': 1}",2,2,"{'LD4': 1, 'LD3': 1}","Brainstorming,Feature"
1896,1,0.333333333,1,2012-10-02T06:00:48Z,2012-10-04T06:16:11Z,3,2,1,0.333333333,2,1,1,0,{'LD3': 1},1,0,{'LD3': 1},
1897,9,0.036885246,4.5,2012-10-02T08:00:08Z,2013-06-03T05:21:04Z,244,242,2,0.008196721,1,5,4,5,"{'LD1': 2, 'LD3': 1, 'LD4': 1}",3,2,"{'LD1': 2, 'LD3': 1, 'LD4': 1}",
1898,3,0.004143646,1.5,2012-10-02T08:14:14Z,2014-09-25T10:10:50Z,724,722,2,0.002762431,3,3,1,2,{'LD3': 1},1,2,{'LD3': 1},"Brainstorming,Refactoring"
1903,2,0.011299435,2,2012-10-03T11:49:18Z,2013-03-29T10:14:49Z,177,176,1,0.005649718,1,1,1,1,{'LD1': 1},1,0,{'LD1': 1},
1912,3,0.002457002,3,2012-10-06T20:20:20Z,2016-02-09T15:41:01Z,1221,1220,1,0.000819001,2,2,1,2,{'LD1': 1},1,1,{'LD1': 1},Brainstorming
1919,4,4,4,2012-10-10T10:57:42Z,2012-10-11T06:25:26Z,1,0,1,1,0,2,1,3,{'LD5': 1},1,1,{'LD5': 1},
1920,2,2,2,2012-10-11T20:17:42Z,2012-10-12T05:50:36Z,1,0,1,1,0,1,1,1,{'LD6': 1},1,0,{'LD6': 1},
1924,2,0.153846154,2,2012-10-12T19:03:16Z,2012-10-25T13:12:27Z,13,12,1,0.076923077,1,2,0,2,{},0,2,{},
1927,4,0.023809524,4,2012-10-13T00:28:02Z,2013-03-29T22:39:47Z,168,167,1,0.005952381,2,2,1,3,{'LD4': 1},1,1,{'LD4': 1},
1928,3,0.003167899,1,2012-10-13T17:06:46Z,2015-05-18T10:34:43Z,947,944,3,0.003167899,3,3,2,1,{'LD4': 2},2,1,{'LD4': 2},"Refactoring,Wallet"
1930,3,0.004942339,3,2012-10-14T10:20:50Z,2014-06-12T14:43:06Z,607,606,1,0.001647446,2,2,0,3,{},0,2,{},"Docs,Refactoring"
1944,8,0.04040404,2,2012-10-22T02:25:55Z,2013-05-07T20:13:33Z,198,194,4,0.02020202,3,5,2,6,"{'LD3': 1, 'LD5': 1}",1,4,"{'LD3': 1, 'LD5': 1}","Bug,GUI,Windows"
1946,3,0.1,3,2012-10-22T07:17:22Z,2012-11-20T14:53:01Z,30,29,1,0.033333333,1,1,3,0,{'LD1': 3},1,0,{'LD1': 1},
1948,5,1.666666667,2.5,2012-10-22T15:49:28Z,2012-10-25T13:37:24Z,3,1,2,0.666666667,1,4,3,2,"{'LD4': 2, 'LD3': 1}",3,1,"{'LD4': 2, 'LD3': 1}",
1950,3,0.75,1.5,2012-10-23T13:00:14Z,2012-10-26T15:15:54Z,4,2,2,0.5,2,3,1,2,{'LD1': 1},1,2,{'LD1': 1},
1951,10,0.09009009,3.333333333,2012-10-23T13:49:43Z,2013-02-11T07:46:37Z,111,108,3,0.027027027,1,5,3,7,"{'LD4': 2, 'LD2': 1}",1,4,"{'LD4': 1, 'LD2': 1}",Bug
1958,4,0.00270453,1,2012-10-25T07:21:55Z,2016-11-11T10:18:16Z,1479,1475,4,0.00270453,4,2,1,3,{'LD5': 1},1,1,{'LD5': 1},"Feature,GUI"
1960,5,0.208333333,1,2012-10-25T09:59:35Z,2012-11-17T14:06:50Z,24,19,5,0.208333333,4,4,4,1,"{'LD3': 3, 'LD2': 1}",3,1,"{'LD3': 2, 'LD2': 1}","Bug,Wallet"
1961,7,0.023728814,1.166666667,2012-10-25T16:45:32Z,2013-08-16T03:27:10Z,295,289,6,0.020338983,7,3,4,3,"{'LD4': 2, 'LD2': 1, 'LD3': 1}",2,1,"{'LD4': 1, 'LD2': 1, 'LD3': 1}","Bug,Wallet"
1964,15,0.04,1.666666667,2012-10-28T20:09:22Z,2013-11-07T12:46:52Z,375,366,9,0.024,3,3,13,2,"{'LD1': 10, 'LD3': 1, 'LD4': 2}",3,0,"{'LD1': 3, 'LD3': 1, 'LD4': 1}",
1968,1,0.011363636,1,2012-10-30T09:01:00Z,2013-01-26T01:09:07Z,88,87,1,0.011363636,2,1,0,1,{},0,1,{},
1969,2,0.005291005,2,2012-10-30T11:01:47Z,2013-11-11T16:59:52Z,378,377,1,0.002645503,1,1,1,1,{'LD1': 1},1,0,{'LD1': 1},
1975,1,0.025,1,2012-11-03T16:36:21Z,2012-12-13T05:26:42Z,40,39,1,0.025,2,1,1,0,{'LD4': 1},1,0,{'LD4': 1},
1985,1,0.002824859,1,2012-11-05T05:49:03Z,2013-10-24T10:41:39Z,354,353,1,0.002824859,1,1,0,1,{},0,1,{},
1994,1,0.001457726,1,2012-11-09T05:23:30Z,2014-09-25T10:11:15Z,686,685,1,0.001457726,2,1,0,1,{},0,1,{},Refactoring
1999,4,0.571428571,1.333333333,2012-11-10T13:22:02Z,2012-11-17T09:03:11Z,7,4,3,0.428571429,2,3,2,2,"{'LD1': 1, 'LD4': 1}",2,1,"{'LD1': 1, 'LD4': 1}",
2007,3,0.003015075,1.5,2012-11-13T15:04:47Z,2015-08-05T08:23:10Z,995,993,2,0.00201005,2,2,0,3,{},0,2,{},Bug
2015,1,0.002770083,1,2012-11-15T20:08:57Z,2013-11-11T15:28:02Z,361,360,1,0.002770083,1,1,1,0,{'LD6': 1},1,0,{'LD6': 1},
2020,1,1,1,2012-11-16T18:40:57Z,2012-11-16T19:03:02Z,1,0,1,1,0,1,0,1,{},0,1,{},
2021,6,0.017647059,1.5,2012-11-16T18:53:28Z,2013-10-22T08:19:42Z,340,336,4,0.011764706,4,4,2,4,{'LD3': 2},2,2,{'LD3': 2},
2025,3,0.428571429,1.5,2012-11-18T11:07:21Z,2012-11-24T16:51:12Z,7,5,2,0.285714286,1,3,1,2,{'LD3': 1},1,2,{'LD3': 1},
2027,4,0.030534351,2,2012-11-18T23:29:06Z,2013-03-29T10:13:24Z,131,129,2,0.015267176,2,4,2,2,"{'LD4': 1, 'LD1': 1}",2,2,"{'LD4': 1, 'LD1': 1}",
2029,3,0.023076923,3,2012-11-19T23:40:40Z,2013-03-29T09:59:13Z,130,129,1,0.007692308,1,2,1,2,{'LD3': 1},1,1,{'LD3': 1},
2034,7,0.009446694,1.4,2012-11-25T14:08:00Z,2014-12-05T17:43:15Z,741,736,5,0.006747638,4,3,2,5,{'LD4': 2},1,2,{'LD4': 1},"Brainstorming,P2P"
2035,11,0.031791908,5.5,2012-11-26T15:23:01Z,2013-11-07T12:24:36Z,346,344,2,0.005780347,1,4,7,4,"{'LD3': 4, 'LD4': 2, 'LD1': 1}",3,1,"{'LD3': 2, 'LD4': 2, 'LD1': 1}",
2036,1,0.001424501,1,2012-11-26T16:29:04Z,2014-10-28T18:32:22Z,702,701,1,0.001424501,1,1,1,0,{'LD5': 1},1,0,{'LD5': 1},Brainstorming
2038,2,0.003649635,2,2012-11-26T21:27:12Z,2014-05-28T07:15:19Z,548,547,1,0.001824818,2,2,1,1,{'LD4': 1},1,1,{'LD4': 1},Bug
2041,1,0.00110742,1,2012-11-26T21:32:06Z,2015-05-18T09:11:28Z,903,902,1,0.00110742,2,1,1,0,{'LD4': 1},1,0,{'LD4': 1},"Bug,Tests"
2043,9,0.073170732,2.25,2012-11-27T01:56:15Z,2013-03-29T10:16:54Z,123,119,4,0.032520325,3,3,3,6,"{'LD1': 1, 'LD4': 2}",2,1,"{'LD1': 1, 'LD4': 2}",
2051,2,0.666666667,1,2012-11-29T10:24:01Z,2012-12-01T12:11:20Z,3,1,2,0.666666667,1,2,1,1,{'LD4': 1},1,1,{'LD4': 1},
2052,1,0.018181818,1,2012-11-29T22:27:02Z,2013-01-22T23:47:58Z,55,54,1,0.018181818,1,1,0,1,{},0,1,{},
2053,1,1,1,2012-11-29T22:37:31Z,2012-11-29T22:40:26Z,1,0,1,1,0,1,0,1,{},0,1,{},
2054,1,0.026315789,1,2012-11-30T13:21:24Z,2013-01-06T16:06:40Z,38,37,1,0.026315789,1,1,0,1,{},0,1,{},
2067,2,2,2,2012-12-04T06:36:08Z,2012-12-04T07:40:18Z,1,0,1,1,0,2,1,1,{'LD4': 1},1,1,{'LD4': 1},
2072,6,0.017751479,6,2012-12-04T17:40:21Z,2013-11-07T12:23:09Z,338,337,1,0.00295858,1,1,3,3,"{'LD4': 1, 'LD1': 2}",1,0,"{'LD4': 1, 'LD1': 1}",
2077,6,0.018461538,1.5,2012-12-05T19:38:19Z,2013-10-26T07:49:31Z,325,321,4,0.012307692,4,3,1,5,{'LD4': 1},1,2,{'LD4': 1},
2078,1,1,1,2012-12-05T22:31:02Z,2012-12-06T08:58:50Z,1,0,1,1,0,1,0,1,{},0,1,{},
2079,8,0.02,4,2012-12-06T18:38:01Z,2014-01-10T11:32:33Z,400,398,2,0.005,2,4,3,5,"{'LD3': 1, 'LD4': 2}",2,2,"{'LD3': 1, 'LD4': 2}",Bug
2083,3,0.008982036,1.5,2012-12-09T02:35:23Z,2013-11-07T12:24:55Z,334,332,2,0.005988024,2,3,2,1,"{'LD4': 1, 'LD1': 1}",2,1,"{'LD4': 1, 'LD1': 1}",
2085,1,0.003115265,1,2012-12-09T12:23:52Z,2013-10-26T07:49:41Z,321,320,1,0.003115265,2,1,1,0,{'LD4': 1},1,0,{'LD4': 1},
2086,7,0.003189066,1,2012-12-09T17:29:42Z,2018-12-13T11:53:01Z,2195,2188,7,0.003189066,5,6,1,6,{'LD4': 1},1,5,{'LD4': 1},"Feature,GUI"
2088,3,0.009036145,1.5,2012-12-10T17:28:35Z,2013-11-07T12:45:20Z,332,330,2,0.006024096,1,2,2,1,"{'LD1': 1, 'LD4': 1}",2,0,"{'LD1': 1, 'LD4': 1}",
2090,1,0.003144654,1,2012-12-11T03:20:07Z,2013-10-24T11:48:41Z,318,317,1,0.003144654,1,1,0,1,{},0,1,{},
2091,11,0.003713707,1.375,2012-12-11T06:56:15Z,2021-01-19T22:43:58Z,2962,2954,8,0.002700878,8,6,3,8,"{'LD4': 1, 'LD6': 1, 'LD2': 1}",2,4,"{'LD4': 1, 'LD6': 1, 'LD2': 1}","Feature,P2P,Privacy"
2092,2,0.666666667,2,2012-12-11T21:40:05Z,2012-12-14T02:43:54Z,3,2,1,0.333333333,1,2,0,2,{},0,2,{},
2093,1,0.003021148,1,2012-12-11T21:47:42Z,2013-11-07T12:34:12Z,331,330,1,0.003021148,2,1,0,1,{},0,1,{},Refactoring
2107,1,0.034482759,1,2012-12-14T02:42:58Z,2013-01-11T16:13:36Z,29,28,1,0.034482759,1,1,1,0,{'LD5': 1},1,0,{'LD5': 1},Bug
2111,1,0.005181347,1,2012-12-16T02:45:03Z,2013-06-26T17:53:44Z,193,192,1,0.005181347,2,1,0,1,{},0,1,{},
2119,1,0.003058104,1,2012-12-20T16:35:56Z,2013-11-11T17:15:31Z,327,326,1,0.003058104,1,1,1,0,{'LD5': 1},1,0,{'LD5': 1},
2127,2,0.001574803,1,2012-12-24T13:29:20Z,2016-06-16T10:08:49Z,1270,1268,2,0.001574803,2,1,1,1,{'LD5': 1},1,0,{'LD5': 1},"Bug,Wallet"
2132,1,0.125,1,2012-12-27T16:29:25Z,2013-01-03T18:02:03Z,8,7,1,0.125,1,1,1,0,{'LD4': 1},1,0,{'LD4': 1},
2134,2,0.004694836,2,2012-12-28T16:57:03Z,2014-02-27T03:17:14Z,426,425,1,0.002347418,1,2,1,1,{'LD4': 1},1,1,{'LD4': 1},Refactoring
2136,1,1,1,2012-12-29T00:37:50Z,2012-12-29T03:23:40Z,1,0,1,1,0,1,0,1,{},0,1,{},
2137,4,0.133333333,1,2012-12-30T10:06:02Z,2013-01-28T17:27:43Z,30,26,4,0.133333333,3,2,3,1,"{'LD4': 1, 'LD6': 1, 'LD5': 1}",2,0,"{'LD4': 1, 'LD6': 1, 'LD5': 1}","Bug,GUI"
2138,1,0.002087683,1,2012-12-31T12:47:48Z,2014-04-23T14:55:05Z,479,478,1,0.002087683,1,1,1,0,{'LD4': 1},1,0,{'LD4': 1},Refactoring
2144,2,0.5,1,2013-01-03T01:47:56Z,2013-01-06T22:01:03Z,4,2,2,0.5,1,1,1,1,{'LD5': 1},1,0,{'LD5': 1},
2146,1,0.035714286,1,2013-01-03T20:04:04Z,2013-01-30T20:29:43Z,28,27,1,0.035714286,1,1,1,0,{'LD2': 1},1,0,{'LD2': 1},
2158,2,2,2,2013-01-08T22:18:45Z,2013-01-08T23:57:30Z,1,0,1,1,0,2,1,1,{'LD5': 1},1,1,{'LD5': 1},
2164,4,0.013071895,2,2013-01-10T01:18:11Z,2013-11-11T17:12:46Z,306,304,2,0.006535948,1,2,2,2,{'LD4': 2},1,1,{'LD4': 1},
2170,4,0.014084507,4,2013-01-11T16:44:09Z,2013-10-22T08:17:16Z,284,283,1,0.003521127,1,2,3,1,{'LD4': 3},2,0,{'LD4': 2},
2175,4,0.014035088,4,2013-01-14T11:19:40Z,2013-10-25T14:39:32Z,285,284,1,0.003508772,1,2,2,2,{'LD4': 2},1,1,{'LD4': 1},
2176,2,0.025,1,2013-01-14T11:25:30Z,2013-04-03T14:11:11Z,80,78,2,0.025,1,1,1,1,{'LD1': 1},1,0,{'LD1': 1},
2178,12,0.8,6,2013-01-14T17:07:05Z,2013-01-28T18:56:39Z,15,13,2,0.133333333,2,6,4,8,"{'LD4': 2, 'LD1': 1, 'LD5': 1}",3,3,"{'LD4': 2, 'LD1': 1, 'LD5': 1}",Bug
2180,2,0.001576044,1,2013-01-14T18:53:45Z,2016-07-06T13:59:15Z,1269,1267,2,0.001576044,1,2,2,0,"{'LD3': 1, 'LD5': 1}",2,0,"{'LD3': 1, 'LD5': 1}","Feature,GUI"
2183,6,6,6,2013-01-16T13:26:38Z,2013-01-16T18:02:23Z,1,0,1,1,0,4,3,3,"{'LD1': 1, 'LD5': 2}",3,1,"{'LD1': 1, 'LD5': 2}",
2185,3,0.010676157,1.5,2013-01-18T13:03:13Z,2013-10-25T14:39:17Z,281,279,2,0.007117438,3,2,2,1,"{'LD3': 1, 'LD4': 1}",2,0,"{'LD3': 1, 'LD4': 1}",
2191,1,0.333333333,1,2013-01-19T13:09:38Z,2013-01-21T17:53:40Z,3,2,1,0.333333333,1,1,0,1,{},0,1,{},
2196,1,0.003623188,1,2013-01-22T15:25:45Z,2013-10-25T14:37:09Z,276,275,1,0.003623188,1,1,0,1,{},0,1,{},
2197,9,0.018255578,1.5,2013-01-22T16:06:05Z,2014-05-29T22:13:51Z,493,487,6,0.012170385,3,5,3,6,"{'LD3': 1, 'LD1': 1, 'LD5': 1}",2,3,"{'LD3': 1, 'LD1': 1, 'LD5': 1}",Windows
2200,1,0.25,1,2013-01-22T23:26:06Z,2013-01-26T01:01:50Z,4,3,1,0.25,1,1,0,1,{},0,1,{},
2201,1,0.125,1,2013-01-22T23:28:25Z,2013-01-30T20:30:15Z,8,7,1,0.125,1,1,1,0,{'LD2': 1},1,0,{'LD2': 1},
2203,7,0.076923077,3.5,2013-01-22T23:33:38Z,2013-04-23T23:17:38Z,91,89,2,0.021978022,1,2,0,7,{},0,2,{},
2204,2,0.020408163,1,2013-01-23T02:33:47Z,2013-04-30T15:55:05Z,98,96,2,0.020408163,2,2,1,1,{'LD3': 1},1,1,{'LD3': 1},Bug
2205,1,0.25,1,2013-01-23T15:57:51Z,2013-01-26T18:49:16Z,4,3,1,0.25,1,1,1,0,{'LD3': 1},1,0,{'LD3': 1},
2206,1,0.125,1,2013-01-23T16:02:55Z,2013-01-30T20:29:59Z,8,7,1,0.125,1,1,0,1,{},0,1,{},
2212,1,0.000908265,1,2013-01-24T07:30:27Z,2016-01-29T13:08:12Z,1101,1100,1,0.000908265,1,1,1,0,{'LD4': 1},1,0,{'LD4': 1},Bug
2214,9,0.011538462,1.5,2013-01-25T17:17:08Z,2015-03-16T10:17:25Z,780,774,6,0.007692308,4,4,2,7,{'LD3': 2},2,2,{'LD3': 2},"GUI,Refactoring"
2216,5,1,2.5,2013-01-25T23:37:49Z,2013-01-30T20:27:10Z,5,3,2,0.4,2,3,1,4,{'LD3': 1},1,2,{'LD3': 1},
2218,5,0.017482517,2.5,2013-01-26T07:46:44Z,2013-11-07T12:48:30Z,286,284,2,0.006993007,2,2,2,3,"{'LD4': 1, 'LD6': 1}",1,1,"{'LD4': 1, 'LD6': 1}",
2225,2,0.028985507,1,2013-01-27T11:48:26Z,2013-04-06T10:46:49Z,69,67,2,0.028985507,2,2,2,0,"{'LD4': 1, 'LD3': 1}",2,0,"{'LD4': 1, 'LD3': 1}",
2230,1,0.071428571,1,2013-01-28T16:01:21Z,2013-02-10T21:19:21Z,14,13,1,0.071428571,1,1,0,1,{},0,1,{},
2233,8,0.235294118,4,2013-01-29T10:37:48Z,2013-03-03T13:17:35Z,34,32,2,0.058823529,1,2,5,3,"{'LD3': 2, 'LD1': 2, 'LD4': 1}",2,0,"{'LD3': 1, 'LD1': 1, 'LD4': 1}",
2238,1,1,1,2013-01-30T12:08:31Z,2013-01-30T20:40:13Z,1,0,1,1,0,1,1,0,{'LD2': 1},1,0,{'LD2': 1},
2239,1,1,1,2013-01-30T13:02:38Z,2013-01-30T23:33:05Z,1,0,1,1,0,1,1,0,{'LD3': 1},1,0,{'LD3': 1},Bug
2240,2,2,2,2013-01-30T14:43:43Z,2013-01-30T15:15:53Z,1,0,1,1,0,2,0,2,{},0,2,{},
2254,2,0.285714286,2,2013-01-31T18:30:40Z,2013-02-06T20:59:10Z,7,6,1,0.142857143,2,1,1,1,{'LD3': 1},1,0,{'LD3': 1},
2261,9,0.264705882,4.5,2013-02-01T20:49:45Z,2013-03-07T11:06:35Z,34,32,2,0.058823529,2,5,6,3,"{'LD1': 2, 'LD4': 2, 'LD3': 1, 'LD5': 1}",5,0,"{'LD1': 2, 'LD4': 2, 'LD3': 1, 'LD5': 1}",
2263,2,0.666666667,1,2013-02-01T21:50:56Z,2013-02-04T19:03:09Z,3,1,2,0.666666667,1,2,1,1,{'LD4': 1},1,1,{'LD4': 1},
2267,5,0.004512635,5,2013-02-03T19:14:36Z,2016-02-16T15:27:52Z,1108,1107,1,0.000902527,2,2,0,5,{},0,2,{},Bug
2268,4,4,4,2013-02-03T20:16:49Z,2013-02-04T07:36:18Z,1,0,1,1,0,3,2,2,"{'LD1': 1, 'LD5': 1}",1,2,"{'LD1': 1, 'LD5': 1}",
2269,4,4,4,2013-02-04T17:09:47Z,2013-02-04T19:02:02Z,1,0,1,1,0,2,1,3,{'LD1': 1},1,1,{'LD1': 1},
2270,1,1,1,2013-02-04T17:17:15Z,2013-02-04T19:01:07Z,1,0,1,1,0,1,1,0,{'LD5': 1},1,0,{'LD5': 1},
2271,4,4,4,2013-02-04T17:26:16Z,2013-02-04T19:00:38Z,1,0,1,1,0,2,1,3,{'LD3': 1},1,1,{'LD3': 1},
2274,1,0.5,1,2013-02-04T23:01:37Z,2013-02-06T13:57:18Z,2,1,1,0.5,1,1,1,0,{'LD4': 1},1,0,{'LD4': 1},
2276,6,0.022988506,6,2013-02-05T18:46:39Z,2013-10-24T11:13:39Z,261,260,1,0.003831418,1,3,1,5,{'LD4': 1},1,2,{'LD4': 1},Brainstorming
2278,4,2,4,2013-02-06T13:47:53Z,2013-02-07T15:09:49Z,2,1,1,0.5,1,4,1,3,{'LD3': 1},1,3,{'LD3': 1},
2280,3,0.004470939,1.5,2013-02-06T17:36:09Z,2014-12-09T13:02:30Z,671,669,2,0.002980626,3,3,0,3,{},0,3,{},Bug
2284,1,1,1,2013-02-07T10:09:08Z,2013-02-07T14:51:38Z,1,0,1,1,0,1,1,0,{'LD1': 1},1,0,{'LD1': 1},
2285,1,0.2,1,2013-02-07T15:06:01Z,2013-02-12T00:01:39Z,5,4,1,0.2,1,1,0,1,{},0,1,{},macOS
2290,6,0.009174312,1.5,2013-02-09T20:31:01Z,2014-11-25T04:30:17Z,654,650,4,0.006116208,4,2,2,4,"{'LD1': 1, 'LD4': 1}",2,0,"{'LD1': 1, 'LD4': 1}","Bug,Build system"
2292,1,1,1,2013-02-09T23:53:12Z,2013-02-10T00:14:05Z,1,0,1,1,0,1,1,0,{'LD3': 1},1,0,{'LD3': 1},
2293,20,0.032,1.818181818,2013-02-10T17:38:24Z,2014-10-27T20:44:02Z,625,614,11,0.0176,9,5,5,15,"{'LD1': 1, 'LD4': 1, 'LD3': 2, 'LD6': 1}",3,2,"{'LD1': 1, 'LD4': 1, 'LD3': 1, 'LD6': 1}","Bug,UTXO Db and Indexes"
2296,2,0.0078125,2,2013-02-10T20:50:53Z,2013-10-24T11:06:59Z,256,255,1,0.00390625,1,2,2,0,{'LD4': 2},2,0,{'LD4': 2},
2300,2,0.002911208,2,2013-02-12T18:27:28Z,2014-12-31T14:18:27Z,687,686,1,0.001455604,1,2,0,2,{},0,2,{},Bug
2301,1,0.003861004,1,2013-02-12T22:46:06Z,2013-10-29T05:40:19Z,259,258,1,0.003861004,1,1,0,1,{},0,1,{},"Bug,GUI"
2302,3,0.001140251,1,2013-02-12T22:57:08Z,2020-04-27T22:04:54Z,2631,2628,3,0.001140251,3,3,0,3,{},0,3,{},"Bug,GUI"
2303,4,0.003663004,4,2013-02-13T06:44:10Z,2016-02-09T15:36:54Z,1092,1091,1,0.000915751,1,2,1,3,{'LD4': 1},1,1,{'LD4': 1},Refactoring
2305,7,0.084337349,1.75,2013-02-13T21:53:36Z,2013-05-07T20:16:18Z,83,79,4,0.048192771,3,6,4,3,"{'LD4': 2, 'LD1': 2}",3,3,"{'LD4': 2, 'LD1': 2}",
2306,2,0.026666667,2,2013-02-13T23:46:35Z,2013-04-29T22:08:44Z,75,74,1,0.013333333,1,1,0,2,{},0,1,{},Bug
2307,2,0.007905138,2,2013-02-14T06:23:42Z,2013-10-24T11:46:42Z,253,252,1,0.003952569,1,1,1,1,{'LD4': 1},1,0,{'LD4': 1},
2313,3,0.011152416,3,2013-02-16T13:22:33Z,2013-11-11T17:05:45Z,269,268,1,0.003717472,1,3,1,2,{'LD1': 1},1,2,{'LD1': 1},
2318,6,0.008823529,2,2013-02-19T16:07:23Z,2014-12-31T14:23:10Z,680,677,3,0.004411765,2,5,1,5,{'LD2': 1},1,4,{'LD2': 1},Refactoring
2319,2,0.00754717,1,2013-02-20T03:04:25Z,2013-11-11T15:04:18Z,265,263,2,0.00754717,3,2,1,1,{'LD4': 1},1,1,{'LD4': 1},
2321,1,1,1,2013-02-20T04:28:06Z,2013-02-20T23:48:04Z,1,0,1,1,0,1,1,0,{'LD2': 1},1,0,{'LD2': 1},
2322,2,2,2,2013-02-20T04:39:28Z,2013-02-20T23:48:30Z,1,0,1,1,0,2,2,0,"{'LD1': 1, 'LD6': 1}",2,0,"{'LD1': 1, 'LD6': 1}",
2324,3,3,3,2013-02-20T09:45:29Z,2013-02-20T20:15:58Z,1,0,1,1,0,1,2,1,"{'LD6': 1, 'LD3': 1}",1,0,"{'LD6': 1, 'LD3': 1}",macOS
2327,1,1,1,2013-02-21T06:44:43Z,2013-02-21T09:57:32Z,1,0,1,1,0,1,1,0,{'LD5': 1},1,0,{'LD5': 1},
2329,3,0.75,1.5,2013-02-22T06:56:50Z,2013-02-25T09:14:56Z,4,2,2,0.5,1,3,1,2,{'LD5': 1},1,2,{'LD5': 1},
2330,6,0.024793388,2,2013-02-23T05:53:56Z,2013-10-22T08:11:53Z,242,239,3,0.012396694,1,3,3,3,"{'LD5': 2, 'LD1': 1}",1,2,"{'LD5': 1, 'LD1': 1}",
2334,7,0.026923077,3.5,2013-02-24T19:15:39Z,2013-11-11T15:14:05Z,260,258,2,0.007692308,3,2,1,6,{'LD3': 1},1,1,{'LD3': 1},
2339,3,0.75,1,2013-02-27T21:11:59Z,2013-03-02T21:26:09Z,4,1,3,0.75,1,1,3,0,"{'LD4': 1, 'LD1': 1, 'LD5': 1}",1,0,"{'LD4': 1, 'LD1': 1, 'LD5': 1}",
2344,1,0.004310345,1,2013-03-04T23:23:00Z,2013-10-22T08:11:29Z,232,231,1,0.004310345,1,1,1,0,{'LD1': 1},1,0,{'LD1': 1},
2345,8,0.034188034,2,2013-03-06T10:24:50Z,2013-10-25T11:01:20Z,234,230,4,0.017094017,2,3,4,4,{'LD4': 4},2,1,{'LD4': 2},
2346,2,2,2,2013-03-06T18:32:05Z,2013-03-06T22:13:50Z,1,0,1,1,0,1,0,2,{},0,1,{},
2347,3,0.012931034,3,2013-03-06T22:55:51Z,2013-10-24T11:45:31Z,232,231,1,0.004310345,1,2,2,1,"{'LD4': 1, 'LD2': 1}",2,0,"{'LD4': 1, 'LD2': 1}",
2353,3,0.007159905,1,2013-03-10T20:22:34Z,2014-05-03T10:36:54Z,419,416,3,0.007159905,3,3,1,2,{'LD4': 1},1,2,{'LD4': 1},Bug
2354,1,1,1,2013-03-10T20:22:48Z,2013-03-11T16:36:30Z,1,0,1,1,0,1,1,0,{'LD5': 1},1,0,{'LD5': 1},
2355,6,0.005628518,2,2013-03-11T04:39:14Z,2016-02-09T15:57:34Z,1066,1063,3,0.002814259,4,5,3,3,{'LD1': 3},2,3,{'LD1': 2},"Brainstorming,Docs"
2356,2,2,2,2013-03-11T07:59:31Z,2013-03-12T00:23:15Z,1,0,1,1,0,2,1,1,{'LD3': 1},1,1,{'LD3': 1},
2358,1,1,1,2013-03-12T02:39:22Z,2013-03-12T16:20:35Z,1,0,1,1,0,1,1,0,{'LD1': 1},1,0,{'LD1': 1},
2359,1,1,1,2013-03-12T09:13:55Z,2013-03-12T12:54:49Z,1,0,1,1,0,1,0,1,{},0,1,{},
2360,2,0.006578947,1,2013-03-12T19:14:11Z,2014-01-10T12:01:26Z,304,302,2,0.006578947,3,2,2,0,{'LD4': 2},2,0,{'LD4': 2},GUI
2362,2,0.00250941,2,2013-03-13T06:31:09Z,2015-05-18T08:44:07Z,797,796,1,0.001254705,1,1,2,0,{'LD4': 2},1,0,{'LD4': 1},"Bug,GUI"
2363,4,0.235294118,1.333333333,2013-03-13T08:36:06Z,2013-03-29T09:06:41Z,17,14,3,0.176470588,2,4,2,2,"{'LD3': 1, 'LD4': 1}",2,2,"{'LD3': 1, 'LD4': 1}",
2365,1,1,1,2013-03-14T00:09:51Z,2013-03-14T17:24:33Z,1,0,1,1,0,1,1,0,{'LD1': 1},1,0,{'LD1': 1},
2368,1,0.001028807,1,2013-03-14T19:17:56Z,2015-11-11T10:36:47Z,972,971,1,0.001028807,1,1,0,1,{},0,1,{},Brainstorming
2369,7,7,7,2013-03-15T06:04:24Z,2013-03-15T18:40:47Z,1,0,1,1,0,2,3,4,"{'LD4': 2, 'LD1': 1}",1,1,"{'LD4': 1, 'LD1': 1}",
2370,2,0.00896861,1,2013-03-15T23:19:29Z,2013-10-24T11:05:28Z,223,221,2,0.00896861,3,2,1,1,{'LD1': 1},1,1,{'LD1': 1},
2371,21,0.07,2.333333333,2013-03-16T16:12:34Z,2014-01-10T12:01:58Z,300,291,9,0.03,8,3,9,12,"{'LD6': 2, 'LD4': 3, 'LD1': 4}",2,1,"{'LD6': 2, 'LD4': 2, 'LD1': 2}","Bug,GUI,macOS"
2372,1,0.022222222,1,2013-03-16T16:18:24Z,2013-04-30T15:56:32Z,45,44,1,0.022222222,1,1,1,0,{'LD4': 1},1,0,{'LD4': 1},"Bug,GUI"
2374,2,0.009009009,1,2013-03-16T21:55:52Z,2013-10-24T10:52:23Z,222,220,2,0.009009009,2,1,1,1,{'LD4': 1},1,0,{'LD4': 1},
2377,2,0.021052632,1,2013-03-17T23:16:15Z,2013-06-20T19:17:49Z,95,93,2,0.021052632,3,2,1,1,{'LD4': 1},1,1,{'LD4': 1},
2380,1,1,1,2013-03-18T18:12:44Z,2013-03-18T18:27:46Z,1,0,1,1,0,1,0,1,{},0,1,{},
2388,1,0.003367003,1,2013-03-20T00:52:34Z,2014-01-10T12:25:29Z,297,296,1,0.003367003,1,1,0,1,{},0,1,{},"Docs,Refactoring"
2389,7,0.03196347,1.4,2013-03-20T03:39:20Z,2013-10-24T11:04:55Z,219,214,5,0.02283105,3,4,5,2,"{'LD1': 2, 'LD3': 1, 'LD4': 2}",3,1,"{'LD1': 2, 'LD3': 1, 'LD4': 2}",
2390,1,0.001079914,1,2013-03-20T06:44:36Z,2015-10-01T12:08:57Z,926,925,1,0.001079914,1,1,1,0,{'LD4': 1},1,0,{'LD4': 1},Bug
2392,6,6,6,2013-03-20T16:04:39Z,2013-03-21T09:20:16Z,1,0,1,1,0,4,1,5,{'LD3': 1},1,3,{'LD3': 1},
2394,12,0.011363636,1.5,2013-03-20T20:48:53Z,2016-02-09T15:33:37Z,1056,1048,8,0.007575758,7,7,6,6,"{'LD1': 2, 'LD3': 2, 'LD4': 1, 'LD6': 1}",4,3,"{'LD1': 2, 'LD3': 2, 'LD4': 1, 'LD6': 1}","Bug,Wallet"
2395,7,0.030172414,3.5,2013-03-21T04:41:15Z,2013-11-07T12:21:33Z,232,230,2,0.00862069,1,4,4,3,"{'LD1': 3, 'LD4': 1}",2,2,"{'LD1': 1, 'LD4': 1}",
2397,1,0.004329004,1,2013-03-21T14:13:14Z,2013-11-07T12:20:39Z,231,230,1,0.004329004,1,1,1,0,{'LD5': 1},1,0,{'LD5': 1},
2398,7,0.032258065,2.333333333,2013-03-21T21:57:27Z,2013-10-24T11:44:21Z,217,214,3,0.013824885,2,4,1,6,{'LD4': 1},1,3,{'LD4': 1},
2401,2,0.009389671,2,2013-03-22T11:00:16Z,2013-10-21T10:29:48Z,213,212,1,0.004694836,1,2,0,2,{},0,2,{},
2402,9,0.333333333,3,2013-03-22T17:02:33Z,2013-04-18T16:01:06Z,27,24,3,0.111111111,2,4,5,4,"{'LD1': 1, 'LD4': 2, 'LD6': 2}",3,1,"{'LD1': 1, 'LD4': 2, 'LD6': 2}",
2404,5,0.023148148,1.666666667,2013-03-23T02:31:28Z,2013-10-24T11:13:46Z,216,213,3,0.013888889,2,3,2,3,"{'LD4': 1, 'LD5': 1}",1,2,"{'LD4': 1, 'LD5': 1}",
2405,12,0.260869565,2.4,2013-03-23T02:59:24Z,2013-05-07T20:16:57Z,46,41,5,0.108695652,3,6,2,10,{'LD3': 2},2,4,{'LD3': 2},Bug
2408,5,0.135135135,2.5,2013-03-24T04:12:02Z,2013-04-29T23:09:31Z,37,35,2,0.054054054,2,2,2,3,"{'LD3': 1, 'LD4': 1}",2,0,"{'LD3': 1, 'LD4': 1}",
2413,2,0.003053435,1,2013-03-26T23:28:15Z,2015-01-10T09:59:59Z,655,653,2,0.003053435,2,2,0,2,{},0,2,{},"Refactoring,Windows"
2416,5,0.023696682,1.25,2013-03-28T00:54:52Z,2013-10-24T11:03:28Z,211,207,4,0.018957346,4,2,1,4,{'LD1': 1},1,1,{'LD1': 1},Linux/Unix
2417,2,2,2,2013-03-28T12:31:12Z,2013-03-28T15:39:42Z,1,0,1,1,0,1,0,2,{},0,1,{},
2425,2,2,2,2013-03-29T12:17:38Z,2013-03-30T06:31:49Z,1,0,1,1,0,2,2,0,{'LD1': 2},2,0,{'LD1': 2},
2426,7,0.033333333,1.75,2013-03-29T13:48:13Z,2013-10-25T11:00:55Z,210,206,4,0.019047619,4,4,2,5,"{'LD4': 1, 'LD1': 1}",2,2,"{'LD4': 1, 'LD1': 1}",
2427,1,0.003484321,1,2013-03-29T17:22:45Z,2014-01-10T11:33:32Z,287,286,1,0.003484321,1,1,0,1,{},0,1,{},Refactoring
2429,6,0.028571429,1.5,2013-03-30T04:57:40Z,2013-10-25T11:27:05Z,210,206,4,0.019047619,3,3,3,3,"{'LD1': 2, 'LD4': 1}",3,0,"{'LD1': 2, 'LD4': 1}","Bug,GUI"
2434,6,0.033149171,1.5,2013-04-01T07:36:35Z,2013-09-28T09:17:51Z,181,177,4,0.022099448,4,5,3,3,"{'LD4': 1, 'LD6': 1, 'LD3': 1}",2,3,"{'LD4': 1, 'LD6': 1, 'LD3': 1}","Bug,macOS"
2435,11,0.297297297,1.375,2013-04-01T11:43:07Z,2013-05-07T20:18:05Z,37,29,8,0.216216216,8,9,9,2,"{'LD3': 8, 'LD4': 1}",7,2,"{'LD3': 6, 'LD4': 1}","Bug,macOS"
2436,1,0.333333333,1,2013-04-01T12:40:56Z,2013-04-03T20:33:22Z,3,2,1,0.333333333,2,1,1,0,{'LD6': 1},1,0,{'LD6': 1},
2438,1,0.333333333,1,2013-04-01T12:56:21Z,2013-04-03T20:34:39Z,3,2,1,0.333333333,1,1,0,1,{},0,1,{},
2445,7,0.020710059,1.166666667,2013-04-02T12:36:19Z,2014-03-06T12:25:14Z,338,332,6,0.017751479,4,5,3,4,"{'LD4': 1, 'LD3': 1, 'LD5': 1}",3,2,"{'LD4': 1, 'LD3': 1, 'LD5': 1}",Bug
2447,1,0.5,1,2013-04-02T13:59:14Z,2013-04-03T20:33:01Z,2,1,1,0.5,1,1,1,0,{'LD4': 1},1,0,{'LD4': 1},
2458,2,0.007117438,2,2013-04-04T12:58:43Z,2014-01-10T11:29:55Z,281,280,1,0.003558719,1,2,1,1,{'LD4': 1},1,1,{'LD4': 1},"GUI,Refactoring"
2462,2,0.009950249,2,2013-04-05T05:50:59Z,2013-10-22T08:10:12Z,201,200,1,0.004975124,1,2,0,2,{},0,2,{},
2463,5,0.024875622,2.5,2013-04-05T06:16:07Z,2013-10-22T08:07:22Z,201,199,2,0.009950249,2,1,4,1,"{'LD4': 3, 'LD1': 1}",1,0,"{'LD4': 1, 'LD1': 1}",
2475,5,0.025252525,2.5,2013-04-06T16:38:48Z,2013-10-21T10:29:10Z,198,196,2,0.01010101,2,3,2,3,"{'LD3': 1, 'LD4': 1}",2,1,"{'LD3': 1, 'LD4': 1}",
2476,54,0.069948187,13.5,2013-04-06T18:32:27Z,2015-05-18T08:44:56Z,772,768,4,0.005181347,3,10,18,36,"{'LD4': 6, 'LD3': 8, 'LD6': 3, 'LD5': 1}",7,3,"{'LD4': 3, 'LD3': 5, 'LD6': 2, 'LD5': 1}",Docs
2480,3,0.111111111,1,2013-04-07T08:04:48Z,2013-05-03T21:46:33Z,27,24,3,0.111111111,4,3,2,1,"{'LD1': 1, 'LD6': 1}",2,1,"{'LD1': 1, 'LD6': 1}",Bug
2484,3,0.010791367,3,2013-04-07T15:26:46Z,2014-01-10T12:29:29Z,278,277,1,0.003597122,1,1,2,1,"{'LD3': 1, 'LD4': 1}",1,0,"{'LD3': 1, 'LD4': 1}","Bug,GUI"
2485,3,0.013761468,1.5,2013-04-07T19:59:50Z,2013-11-11T15:18:03Z,218,216,2,0.009174312,2,2,2,1,"{'LD1': 1, 'LD3': 1}",2,0,"{'LD1': 1, 'LD3': 1}",
2486,1,1,1,2013-04-08T00:32:10Z,2013-04-08T01:32:19Z,1,0,1,1,0,1,0,1,{},0,1,{},
2488,1,0.038461538,1,2013-04-08T15:58:04Z,2013-05-03T22:18:10Z,26,25,1,0.038461538,1,1,0,1,{},0,1,{},
2489,1,0.333333333,1,2013-04-09T03:07:30Z,2013-04-12T00:13:29Z,3,2,1,0.333333333,1,1,0,1,{},0,1,{},
2496,4,4,4,2013-04-09T18:05:09Z,2013-04-09T20:30:12Z,1,0,1,1,0,3,1,3,{'LD4': 1},1,2,{'LD4': 1},GUI
2499,12,0.235294118,3,2013-04-09T22:23:50Z,2013-05-30T12:51:18Z,51,47,4,0.078431373,2,4,7,5,"{'LD4': 3, 'LD1': 2, 'LD2': 2}",2,2,"{'LD4': 2, 'LD1': 2, 'LD2': 1}",
2500,2,2,2,2013-04-10T05:13:37Z,2013-04-10T13:17:39Z,1,0,1,1,0,1,0,2,{},0,1,{},
2504,1,0.005128205,1,2013-04-11T00:56:19Z,2013-10-22T08:08:31Z,195,194,1,0.005128205,1,1,0,1,{},0,1,{},
2505,1,1,1,2013-04-11T03:58:01Z,2013-04-11T04:35:31Z,1,0,1,1,0,1,0,1,{},0,1,{},
2506,3,0.111111111,1.5,2013-04-11T08:52:52Z,2013-05-07T15:38:18Z,27,25,2,0.074074074,2,3,0,3,{},0,3,{},
2509,1,1,1,2013-04-11T13:46:44Z,2013-04-11T14:14:54Z,1,0,1,1,0,1,0,1,{},0,1,{},
2511,3,0.001675042,1.5,2013-04-11T18:05:44Z,2018-03-06T18:06:00Z,1791,1789,2,0.001116695,2,3,1,2,{'LD3': 1},1,2,{'LD3': 1},"Resource usage,Wallet"
2512,2,0.006309148,1,2013-04-11T18:54:54Z,2014-02-22T11:06:57Z,317,315,2,0.006309148,2,2,1,1,{'LD4': 1},1,1,{'LD4': 1},Refactoring
2517,2,0.117647059,1,2013-04-13T01:44:32Z,2013-04-29T23:11:32Z,17,15,2,0.117647059,3,1,0,2,{},0,1,{},
2518,6,1.2,2,2013-04-13T06:34:46Z,2013-04-17T21:21:01Z,5,2,3,0.6,1,3,2,4,{'LD4': 2},1,2,{'LD4': 1},
2521,8,0.041237113,2,2013-04-13T22:36:18Z,2013-10-24T11:43:00Z,194,190,4,0.020618557,4,4,5,3,"{'LD4': 2, 'LD1': 2, 'LD3': 1}",4,0,"{'LD4': 2, 'LD1': 2, 'LD3': 1}",
2522,2,0.125,1,2013-04-13T23:47:08Z,2013-04-29T23:28:56Z,16,14,2,0.125,2,2,1,1,{'LD4': 1},1,1,{'LD4': 1},
2529,3,0.25,1,2013-04-14T19:13:57Z,2013-04-26T18:33:57Z,12,9,3,0.25,2,3,2,1,"{'LD4': 1, 'LD5': 1}",2,1,"{'LD4': 1, 'LD5': 1}",
2531,1,0.005181347,1,2013-04-14T23:49:33Z,2013-10-24T10:56:33Z,193,192,1,0.005181347,1,1,0,1,{},0,1,{},Build system
2533,6,0.031746032,1.5,2013-04-15T16:27:22Z,2013-10-21T10:25:09Z,189,185,4,0.021164021,4,4,3,3,"{'LD4': 1, 'LD3': 2}",3,1,"{'LD4': 1, 'LD3': 2}",
2534,1,0.015873016,1,2013-04-15T18:32:38Z,2013-06-17T08:45:14Z,63,62,1,0.015873016,2,1,1,0,{'LD4': 1},1,0,{'LD4': 1},
2542,7,0.007486631,1.4,2013-04-20T14:43:48Z,2015-11-11T10:17:26Z,935,930,5,0.005347594,4,3,0,7,{},0,3,{},"Bug,P2P"
2543,8,0.042780749,2.666666667,2013-04-20T15:52:05Z,2013-10-24T11:42:41Z,187,184,3,0.016042781,3,3,0,8,{},0,3,{},"Bug,GUI"
2545,5,0.001952362,1.25,2013-04-22T07:47:47Z,2020-04-26T00:43:38Z,2561,2557,4,0.00156189,4,5,5,0,"{'LD4': 3, 'LD3': 2}",5,0,"{'LD4': 3, 'LD3': 2}","Brainstorming,Feature,Wallet,macOS"
2547,15,0.055350554,1.666666667,2013-04-22T12:23:18Z,2014-01-17T12:32:49Z,271,262,9,0.033210332,6,4,6,9,"{'LD4': 2, 'LD3': 4}",2,2,"{'LD4': 1, 'LD3': 2}","Bug,Windows"
2548,2,0.666666667,2,2013-04-22T12:36:17Z,2013-04-24T15:50:00Z,3,2,1,0.333333333,1,2,1,1,{'LD3': 1},1,1,{'LD3': 1},
2549,2,0.002143623,1,2013-04-22T13:30:04Z,2015-11-11T10:05:53Z,933,931,2,0.002143623,3,2,1,1,{'LD3': 1},1,1,{'LD3': 1},"GUI,Refactoring"
2550,6,0.375,1.5,2013-04-22T15:20:38Z,2013-05-07T20:18:24Z,16,12,4,0.25,2,3,3,3,"{'LD4': 2, 'LD3': 1}",2,1,"{'LD4': 1, 'LD3': 1}","Bug,macOS"
2551,5,0.005428882,1.25,2013-04-23T06:45:32Z,2015-10-30T21:33:21Z,921,917,4,0.004343105,4,4,1,4,{'LD4': 1},1,3,{'LD4': 1},"Brainstorming,Refactoring"
2555,9,0.049450549,9,2013-04-23T14:55:34Z,2013-10-22T08:03:08Z,182,181,1,0.005494505,1,5,5,4,"{'LD1': 2, 'LD3': 3}",3,2,"{'LD1': 2, 'LD3': 3}",
2560,3,0.003218884,3,2013-04-24T01:58:50Z,2015-11-11T10:05:24Z,932,931,1,0.001072961,1,3,1,2,{'LD3': 1},1,2,{'LD3': 1},"GUI,Refactoring"
2567,2,0.166666667,1,2013-04-25T21:01:43Z,2013-05-07T18:46:21Z,12,10,2,0.166666667,2,2,1,1,{'LD4': 1},1,1,{'LD4': 1},
2570,4,0.068965517,2,2013-04-26T00:36:29Z,2013-06-22T19:04:00Z,58,56,2,0.034482759,1,3,0,4,{},0,3,{},Bug
2571,1,1,1,2013-04-26T04:19:09Z,2013-04-26T05:41:23Z,1,0,1,1,0,1,0,1,{},0,1,{},
2576,1,1,1,2013-04-26T11:55:55Z,2013-04-27T09:07:22Z,1,0,1,1,0,1,0,1,{},0,1,{},
2581,1,1,1,2013-04-27T04:03:06Z,2013-04-27T14:10:19Z,1,0,1,1,0,1,0,1,{},0,1,{},
2585,2,1,2,2013-04-27T14:52:07Z,2013-04-28T15:00:55Z,2,1,1,0.5,1,2,0,2,{},0,2,{},
2587,3,0.75,1.5,2013-04-28T14:31:29Z,2013-05-02T08:02:50Z,4,2,2,0.5,1,2,0,3,{},0,2,{},
2591,1,0.5,1,2013-04-29T16:54:05Z,2013-04-30T16:54:11Z,2,1,1,0.5,1,1,1,0,{'LD5': 1},1,0,{'LD5': 1},
2594,3,0.25,3,2013-04-30T09:09:57Z,2013-05-12T09:02:46Z,12,11,1,0.083333333,2,2,2,1,"{'LD1': 1, 'LD2': 1}",2,0,"{'LD1': 1, 'LD2': 1}",Bug
2597,1,0.25,1,2013-04-30T15:47:37Z,2013-05-03T22:13:49Z,4,3,1,0.25,1,1,1,0,{'LD2': 1},1,0,{'LD2': 1},Bug
2605,3,3,3,2013-05-02T15:52:48Z,2013-05-03T11:52:04Z,1,0,1,1,0,3,1,2,{'LD4': 1},1,2,{'LD4': 1},"Bug,GUI"
2620,2,0.666666667,2,2013-05-05T11:05:57Z,2013-05-07T17:03:06Z,3,2,1,0.333333333,1,2,1,1,{'LD3': 1},1,1,{'LD3': 1},
2626,15,0.006337136,2.5,2013-05-07T15:24:25Z,2019-10-30T12:22:49Z,2367,2361,6,0.002534854,5,9,4,11,"{'LD4': 2, 'LD2': 1, 'LD5': 1}",3,6,"{'LD4': 2, 'LD2': 1, 'LD5': 1}",Brainstorming
2627,14,1.555555556,2.8,2013-05-07T16:15:45Z,2013-05-16T05:34:56Z,9,4,5,0.555555556,2,6,4,10,"{'LD4': 2, 'LD6': 1, 'LD5': 1}",2,4,"{'LD4': 1, 'LD6': 1, 'LD5': 1}",Refactoring
2628,6,0.032258065,2,2013-05-07T17:25:09Z,2013-11-09T07:00:24Z,186,183,3,0.016129032,3,3,1,5,{'LD3': 1},1,2,{'LD3': 1},
2631,7,0.006944444,1.166666667,2013-05-08T15:31:47Z,2016-02-09T17:07:47Z,1008,1002,6,0.005952381,6,5,6,1,"{'LD4': 2, 'LD3': 1, 'LD2': 1, 'LD1': 2}",5,0,"{'LD4': 2, 'LD3': 1, 'LD2': 1, 'LD1': 2}","Bug,UTXO Db and Indexes,Windows"
2637,1,0.166666667,1,2013-05-10T12:02:21Z,2013-05-16T05:39:19Z,6,5,1,0.166666667,1,1,0,1,{},0,1,{},"GUI,Refactoring"
2639,3,0.002964427,3,2013-05-11T11:30:57Z,2016-02-16T12:49:37Z,1012,1011,1,0.000988142,1,2,1,2,{'LD1': 1},1,1,{'LD1': 1},Bug
2640,1,1,1,2013-05-11T18:07:00Z,2013-05-11T18:39:24Z,1,0,1,1,0,1,1,0,{'LD1': 1},1,0,{'LD1': 1},
2641,4,4,4,2013-05-12T08:58:50Z,2013-05-12T15:45:09Z,1,0,1,1,0,3,2,2,"{'LD3': 1, 'LD4': 1}",2,1,"{'LD3': 1, 'LD4': 1}",
2643,9,0.75,4.5,2013-05-12T12:23:13Z,2013-05-23T16:05:09Z,12,10,2,0.166666667,2,3,4,5,{'LD4': 4},2,1,{'LD4': 2},
2646,3,0.012345679,1.5,2013-05-12T15:35:22Z,2014-01-10T11:27:18Z,243,241,2,0.008230453,1,2,3,0,{'LD4': 3},2,0,{'LD4': 2},Bug
2653,12,0.048192771,1.5,2013-05-13T17:14:32Z,2014-01-17T12:36:40Z,249,241,8,0.032128514,6,9,5,7,"{'LD4': 2, 'LD1': 2, 'LD3': 1}",3,6,"{'LD4': 2, 'LD1': 2, 'LD3': 1}",Refactoring
2654,1,0.5,1,2013-05-14T04:22:33Z,2013-05-15T19:54:33Z,2,1,1,0.5,1,1,0,1,{},0,1,{},
2656,3,0.00795756,1.5,2013-05-16T14:10:29Z,2014-05-28T07:17:14Z,377,375,2,0.00530504,2,3,1,2,{'LD4': 1},1,2,{'LD4': 1},"Feature,GUI"
2659,1,1,1,2013-05-17T05:41:35Z,2013-05-17T18:51:14Z,1,0,1,1,0,1,1,0,{'LD1': 1},1,0,{'LD1': 1},
2662,3,0.016759777,1.5,2013-05-17T17:24:47Z,2013-11-12T14:57:22Z,179,177,2,0.011173184,2,3,1,2,{'LD3': 1},1,2,{'LD3': 1},
2664,14,0.014184397,1.555555556,2013-05-17T19:59:44Z,2016-01-29T13:06:21Z,987,978,9,0.009118541,7,8,6,8,"{'LD4': 4, 'LD3': 2}",5,3,"{'LD4': 4, 'LD3': 2}","Bug,UTXO Db and Indexes"
2673,6,0.004322767,1.5,2013-05-19T22:32:41Z,2017-03-07T18:31:49Z,1388,1384,4,0.002881844,3,5,2,4,"{'LD3': 1, 'LD4': 1}",2,3,"{'LD3': 1, 'LD4': 1}",Feature
2674,4,0.8,2,2013-05-20T00:30:49Z,2013-05-24T09:58:36Z,5,3,2,0.4,1,3,2,2,"{'LD2': 1, 'LD1': 1}",2,1,"{'LD2': 1, 'LD1': 1}",
2675,3,3,3,2013-05-20T11:54:38Z,2013-05-20T16:28:35Z,1,0,1,1,0,2,1,2,{'LD4': 1},1,1,{'LD4': 1},
2676,1,0.5,1,2013-05-20T22:20:55Z,2013-05-22T21:01:31Z,2,1,1,0.5,1,1,0,1,{},0,1,{},
2684,2,2,2,2013-05-23T10:20:54Z,2013-05-23T16:11:13Z,1,0,1,1,0,2,1,1,{'LD5': 1},1,1,{'LD5': 1},
2685,1,1,1,2013-05-23T10:24:54Z,2013-05-23T10:39:58Z,1,0,1,1,0,1,0,1,{},0,1,{},
2686,4,4,4,2013-05-23T17:15:12Z,2013-05-24T09:58:09Z,1,0,1,1,0,3,1,3,{'LD4': 1},1,2,{'LD4': 1},
2689,2,0.002758621,1,2013-05-23T21:41:59Z,2015-05-18T08:43:20Z,725,723,2,0.002758621,2,2,1,1,{'LD1': 1},1,1,{'LD1': 1},"Docs,Feature"
2690,4,0.173913043,1.333333333,2013-05-24T08:40:27Z,2013-06-15T14:40:35Z,23,20,3,0.130434783,2,2,2,2,{'LD4': 2},1,1,{'LD4': 1},
2691,6,0.026315789,1.5,2013-05-24T09:12:08Z,2014-01-07T08:41:12Z,228,224,4,0.01754386,3,2,2,4,"{'LD4': 1, 'LD3': 1}",2,0,"{'LD4': 1, 'LD3': 1}","Bug,GUI,Linux/Unix"
2692,3,0.001595745,1.5,2013-05-24T09:39:31Z,2018-07-16T17:15:48Z,1880,1878,2,0.00106383,2,3,1,2,{'LD4': 1},1,2,{'LD4': 1},"Feature,GUI,Wallet"
2694,1,0.003215434,1,2013-05-25T05:28:03Z,2014-03-31T06:13:33Z,311,310,1,0.003215434,2,1,0,1,{},0,1,{},Brainstorming
2698,3,0.5,1,2013-05-26T06:09:08Z,2013-05-31T12:50:47Z,6,3,3,0.5,2,3,2,1,{'LD1': 2},2,1,{'LD1': 2},
2699,3,3,3,2013-05-26T07:02:42Z,2013-05-26T11:46:22Z,1,0,1,1,0,2,0,3,{},0,2,{},
2701,2,0.002773925,2,2013-05-27T19:48:47Z,2015-05-18T09:28:07Z,721,720,1,0.001386963,2,1,1,1,{'LD3': 1},1,0,{'LD3': 1},Bug
2704,2,0.008547009,1,2013-05-29T01:17:44Z,2014-01-17T16:15:55Z,234,232,2,0.008547009,3,1,1,1,{'LD2': 1},1,0,{'LD2': 1},Bug
2707,4,2,2,2013-05-29T21:57:08Z,2013-05-31T07:34:02Z,2,0,2,1,0,2,1,3,{'LD1': 1},1,1,{'LD1': 1},
2708,3,3,3,2013-05-29T22:40:56Z,2013-05-30T11:48:26Z,1,0,1,1,0,3,2,1,"{'LD3': 1, 'LD4': 1}",2,1,"{'LD3': 1, 'LD4': 1}",
2709,1,1,1,2013-05-29T23:15:59Z,2013-05-30T11:50:12Z,1,0,1,1,0,1,0,1,{},0,1,{},
2710,7,0.002759164,1.166666667,2013-05-29T23:42:41Z,2020-05-08T23:46:20Z,2537,2531,6,0.002364998,6,3,1,6,{'LD2': 1},1,2,{'LD2': 1},"Feature,GUI,Wallet"
2711,2,2,2,2013-05-29T23:54:40Z,2013-05-30T00:39:07Z,1,0,1,1,0,2,0,2,{},0,2,{},
2712,7,0.041916168,2.333333333,2013-05-30T02:21:48Z,2013-11-12T14:46:22Z,167,164,3,0.017964072,1,4,2,5,{'LD3': 2},1,3,{'LD3': 1},
2715,1,0.004444444,1,2013-05-30T13:31:08Z,2014-01-10T11:25:19Z,225,224,1,0.004444444,1,1,1,0,{'LD4': 1},1,0,{'LD4': 1},"GUI,Refactoring"
2717,2,0.006644518,2,2013-05-30T17:56:26Z,2014-03-27T10:20:53Z,301,300,1,0.003322259,1,2,1,1,{'LD4': 1},1,1,{'LD4': 1},Refactoring
2719,3,0.013333333,1.5,2013-05-31T03:27:38Z,2014-01-10T12:12:51Z,225,223,2,0.008888889,2,2,2,1,{'LD4': 2},2,0,{'LD4': 2},"Bug,Windows"
2723,1,0.000574713,1,2013-06-01T00:07:14Z,2018-03-06T22:20:43Z,1740,1739,1,0.000574713,2,1,0,1,{},0,1,{},"Feature,GUI"
2724,8,0.012232416,2,2013-06-01T00:18:02Z,2015-03-16T11:23:27Z,654,650,4,0.006116208,4,2,4,4,"{'LD3': 1, 'LD4': 1, 'LD1': 2}",2,0,"{'LD3': 1, 'LD4': 1, 'LD1': 1}","GUI,Refactoring"
2725,1,1,1,2013-06-01T00:43:17Z,2013-06-01T01:51:26Z,1,0,1,1,0,1,1,0,{'LD4': 1},1,0,{'LD4': 1},
2726,36,0.057416268,1.44,2013-06-02T03:21:08Z,2015-02-18T16:20:23Z,627,602,25,0.039872408,14,12,23,13,"{'LD1': 8, 'LD3': 9, 'LD5': 1, 'LD4': 4, 'LD6': 1}",10,2,"{'LD1': 4, 'LD3': 5, 'LD5': 1, 'LD4': 4, 'LD6': 1}","Bug,UTXO Db and Indexes"
2729,3,0.003089598,1,2013-06-03T11:42:39Z,2016-01-29T13:10:17Z,971,968,3,0.003089598,3,3,0,3,{},0,3,{},Refactoring
2732,1,1,1,2013-06-03T17:03:50Z,2013-06-03T18:30:12Z,1,0,1,1,0,1,0,1,{},0,1,{},
2734,3,0.021276596,3,2013-06-04T00:45:18Z,2013-10-22T07:36:25Z,141,140,1,0.007092199,1,2,1,2,{'LD4': 1},1,1,{'LD4': 1},
2736,3,0.001605996,1,2013-06-04T17:39:48Z,2018-07-16T17:21:48Z,1868,1865,3,0.001605996,4,2,3,0,"{'LD1': 1, 'LD4': 2}",2,0,"{'LD1': 1, 'LD4': 1}","Bug,Wallet"
2737,5,0.005102041,1.666666667,2013-06-04T18:43:55Z,2016-02-09T16:39:41Z,980,977,3,0.003061224,3,4,0,5,{},0,4,{},GUI
2739,2,0.002285714,1,2013-06-05T01:14:53Z,2015-10-27T11:24:08Z,875,873,2,0.002285714,2,2,0,2,{},0,2,{},"Bug,RPC/REST/ZMQ"
2742,2,0.074074074,2,2013-06-05T07:13:21Z,2013-07-01T09:08:25Z,27,26,1,0.037037037,1,2,1,1,{'LD4': 1},1,1,{'LD4': 1},
2745,2,0.007782101,1,2013-06-06T00:53:31Z,2014-02-17T14:32:23Z,257,255,2,0.007782101,2,1,1,1,{'LD2': 1},1,0,{'LD2': 1},Bug
2752,1,0.5,1,2013-06-07T22:34:47Z,2013-06-09T08:06:12Z,2,1,1,0.5,1,1,1,0,{'LD3': 1},1,0,{'LD3': 1},
2753,5,0.03164557,1.666666667,2013-06-07T22:53:47Z,2013-11-12T14:31:53Z,158,155,3,0.018987342,3,5,3,2,"{'LD2': 1, 'LD3': 2}",3,2,"{'LD2': 1, 'LD3': 2}",
2755,4,4,4,2013-06-08T21:54:53Z,2013-06-09T20:46:58Z,1,0,1,1,0,3,3,1,"{'LD1': 2, 'LD4': 1}",2,1,"{'LD1': 2, 'LD4': 1}",
2757,7,0.026022305,1.4,2013-06-10T20:14:45Z,2014-03-06T12:25:44Z,269,264,5,0.018587361,4,4,3,4,"{'LD6': 2, 'LD5': 1}",2,2,"{'LD6': 1, 'LD5': 1}",Brainstorming
2761,1,0.006493506,1,2013-06-11T18:19:53Z,2013-11-12T15:04:57Z,154,153,1,0.006493506,1,1,0,1,{},0,1,{},
2764,2,0.015151515,2,2013-06-12T09:29:09Z,2013-10-21T10:23:32Z,132,131,1,0.007575758,1,2,2,0,"{'LD2': 1, 'LD5': 1}",2,0,"{'LD2': 1, 'LD5': 1}",
2770,80,0.388349515,2.105263158,2013-06-15T00:27:14Z,2014-01-06T09:10:27Z,206,168,38,0.184466019,24,26,20,60,"{'LD3': 6, 'LD4': 8, 'LD1': 4, 'LD6': 1, 'LD5': 1}",14,12,"{'LD3': 5, 'LD4': 7, 'LD1': 3, 'LD6': 1, 'LD5': 1}",Bug
2772,5,0.625,1.666666667,2013-06-15T17:49:15Z,2013-06-23T11:52:12Z,8,5,3,0.375,2,2,1,4,{'LD4': 1},1,1,{'LD4': 1},
2773,2,0.009345794,1,2013-06-17T14:02:46Z,2014-01-17T12:30:26Z,214,212,2,0.009345794,3,2,1,1,{'LD4': 1},1,1,{'LD4': 1},Bug
2774,1,1,1,2013-06-17T22:57:15Z,2013-06-18T13:25:44Z,1,0,1,1,0,1,1,0,{'LD4': 1},1,0,{'LD4': 1},
2779,6,2,6,2013-06-19T18:57:43Z,2013-06-22T13:46:36Z,3,2,1,0.333333333,1,2,1,5,{'LD3': 1},1,1,{'LD3': 1},Bug
2780,1,0.333333333,1,2013-06-19T19:03:59Z,2013-06-22T19:01:37Z,3,2,1,0.333333333,1,1,0,1,{},0,1,{},
2785,7,0.033492823,3.5,2013-06-23T05:02:16Z,2014-01-17T12:28:27Z,209,207,2,0.009569378,3,5,2,5,{'LD4': 2},1,4,{'LD4': 1},"Bug,macOS"
2790,4,0.004499438,2,2013-06-24T19:43:21Z,2015-11-30T14:12:38Z,889,887,2,0.002249719,2,4,4,0,"{'LD4': 2, 'LD3': 2}",4,0,"{'LD4': 2, 'LD3': 2}","GUI,Refactoring"
2800,14,0.068627451,2.333333333,2013-06-27T15:17:22Z,2014-01-17T12:27:21Z,204,198,6,0.029411765,4,8,11,3,"{'LD2': 2, 'LD3': 2, 'LD4': 4, 'LD1': 2, 'LD5': 1}",7,1,"{'LD2': 2, 'LD3': 2, 'LD4': 2, 'LD1': 2, 'LD5': 1}",
2806,9,0.070866142,1.5,2013-07-01T05:47:15Z,2013-11-05T00:50:55Z,127,121,6,0.047244094,4,8,2,7,"{'LD4': 1, 'LD3': 1}",2,6,"{'LD4': 1, 'LD3': 1}",
2811,3,0.015151515,1.5,2013-07-03T12:38:25Z,2014-01-17T12:26:14Z,198,196,2,0.01010101,3,3,1,2,{'LD1': 1},1,2,{'LD1': 1},Refactoring
2813,2,0.333333333,1,2013-07-03T23:40:57Z,2013-07-09T20:46:48Z,6,4,2,0.333333333,2,2,1,1,{'LD1': 1},1,1,{'LD1': 1},
2819,5,0.025252525,2.5,2013-07-09T13:54:44Z,2014-01-23T07:26:15Z,198,196,2,0.01010101,2,5,3,2,"{'LD3': 2, 'LD6': 1}",3,2,"{'LD3': 2, 'LD6': 1}","Build system,Refactoring,Windows"
2821,1,0.001051525,1,2013-07-10T18:40:01Z,2016-02-16T17:27:57Z,951,950,1,0.001051525,2,1,1,0,{'LD4': 1},1,0,{'LD4': 1},Bug
2822,2,0.01754386,2,2013-07-12T11:25:01Z,2013-11-03T01:00:16Z,114,113,1,0.00877193,2,2,0,2,{},0,2,{},Brainstorming
2833,2,0.01369863,2,2013-07-16T22:24:39Z,2013-12-09T15:54:41Z,146,145,1,0.006849315,1,2,2,0,"{'LD4': 1, 'LD1': 1}",2,0,"{'LD4': 1, 'LD1': 1}",
2838,4,0.034482759,1.333333333,2013-07-20T11:10:47Z,2013-11-12T14:24:37Z,116,113,3,0.025862069,2,4,0,4,{},0,4,{},Bug
2843,3,1,1.5,2013-07-22T08:47:28Z,2013-07-25T08:01:57Z,3,1,2,0.666666667,1,1,0,3,{},0,1,{},
2846,1,0.000592066,1,2013-07-23T03:38:48Z,2018-03-07T14:51:30Z,1689,1688,1,0.000592066,2,1,1,0,{'LD3': 1},1,0,{'LD3': 1},"Bug,Wallet"
2853,1,0.004784689,1,2013-07-24T08:14:38Z,2014-02-17T13:40:38Z,209,208,1,0.004784689,1,1,1,0,{'LD4': 1},1,0,{'LD4': 1},Refactoring
2859,3,0.6,1.5,2013-07-25T12:31:28Z,2013-07-29T14:07:15Z,5,3,2,0.4,1,2,1,2,{'LD3': 1},1,1,{'LD3': 1},
2860,2,2,2,2013-07-25T22:51:18Z,2013-07-26T09:06:42Z,1,0,1,1,0,2,0,2,{},0,2,{},
2862,4,0.016877637,1.333333333,2013-07-27T19:44:55Z,2014-03-21T15:53:29Z,237,234,3,0.012658228,3,3,0,4,{},0,3,{},"GUI,Refactoring"
2869,1,0.009615385,1,2013-07-31T21:29:39Z,2013-11-12T15:30:43Z,104,103,1,0.009615385,1,1,0,1,{},0,1,{},
2870,1,0.009708738,1,2013-08-01T17:27:07Z,2013-11-12T14:16:41Z,103,102,1,0.009708738,2,1,1,0,{'LD2': 1},1,0,{'LD2': 1},
2878,3,0.6,1.5,2013-08-05T09:06:07Z,2013-08-10T08:00:26Z,5,3,2,0.4,1,2,1,2,{'LD3': 1},1,1,{'LD3': 1},
2887,1,0.00617284,1,2013-08-08T14:42:47Z,2014-01-17T12:25:39Z,162,161,1,0.00617284,2,1,0,1,{},0,1,{},"Bug,GUI"
2889,13,0.013091641,2.166666667,2013-08-09T22:57:28Z,2016-04-28T11:19:41Z,993,987,6,0.006042296,6,8,4,9,"{'LD3': 1, 'LD4': 2, 'LD2': 1}",4,4,"{'LD3': 1, 'LD4': 2, 'LD2': 1}","Bug,RPC/REST/ZMQ"
2893,1,0.00617284,1,2013-08-13T11:33:26Z,2014-01-21T15:51:59Z,162,161,1,0.00617284,2,1,1,0,{'LD3': 1},1,0,{'LD3': 1},
2894,1,1,1,2013-08-14T09:32:42Z,2013-08-14T22:35:03Z,1,0,1,1,0,1,0,1,{},0,1,{},
2909,2,2,2,2013-08-19T10:24:58Z,2013-08-19T11:57:10Z,1,0,1,1,0,2,1,1,{'LD4': 1},1,1,{'LD4': 1},
2925,2,2,2,2013-08-23T01:00:09Z,2013-08-23T08:33:14Z,1,0,1,1,0,2,1,1,{'LD5': 1},1,1,{'LD5': 1},
2927,12,0.018691589,2.4,2013-08-23T17:12:11Z,2015-05-27T07:33:12Z,642,637,5,0.007788162,6,4,1,11,{'LD1': 1},1,3,{'LD1': 1},Bug
2936,9,0.00414174,3,2013-08-25T00:38:53Z,2019-08-06T06:35:01Z,2173,2170,3,0.00138058,3,3,3,6,"{'LD4': 1, 'LD1': 1, 'LD6': 1}",1,2,"{'LD4': 1, 'LD1': 1, 'LD6': 1}","Bug,GUI,Wallet"
2941,3,0.0375,3,2013-08-25T14:54:30Z,2013-11-12T15:29:39Z,80,79,1,0.0125,1,2,0,3,{},0,2,{},
2942,1,0.012658228,1,2013-08-26T09:37:50Z,2013-11-12T14:14:03Z,79,78,1,0.012658228,1,1,0,1,{},0,1,{},
2953,3,3,3,2013-08-29T19:30:01Z,2013-08-29T19:50:03Z,1,0,1,1,0,2,0,3,{},0,2,{},
2954,5,0.013089005,1,2013-08-30T10:29:12Z,2014-09-15T15:29:09Z,382,377,5,0.013089005,4,4,1,4,{'LD3': 1},1,3,{'LD3': 1},Bug
2962,3,0.003787879,1,2013-08-30T23:45:34Z,2015-10-31T11:29:23Z,792,789,3,0.003787879,2,2,1,2,{'LD3': 1},1,1,{'LD3': 1},Refactoring
2965,7,0.118644068,1.4,2013-09-01T09:33:31Z,2013-10-30T01:01:57Z,59,54,5,0.084745763,5,3,2,5,"{'LD4': 1, 'LD3': 1}",2,1,"{'LD4': 1, 'LD3': 1}",
2971,5,0.005624297,1.666666667,2013-09-04T09:47:47Z,2016-02-09T16:45:08Z,889,886,3,0.003374578,4,3,1,4,{'LD2': 1},1,2,{'LD2': 1},"Refactoring,Wallet"
2972,1,0.5,1,2013-09-04T09:50:53Z,2013-09-05T11:35:47Z,2,1,1,0.5,1,1,0,1,{},0,1,{},
2974,1,0.001277139,1,2013-09-04T15:39:03Z,2015-10-27T11:23:10Z,783,782,1,0.001277139,1,1,1,0,{'LD6': 1},1,0,{'LD6': 1},Refactoring
2983,2,0.007662835,2,2013-09-09T22:17:18Z,2014-05-28T08:17:35Z,261,260,1,0.003831418,2,2,1,1,{'LD1': 1},1,1,{'LD1': 1},Bug
2984,1,0.001897533,1,2013-09-10T12:16:55Z,2015-02-18T16:21:05Z,527,526,1,0.001897533,1,1,0,1,{},0,1,{},Refactoring
2990,4,0.002444988,1.333333333,2013-09-13T13:58:28Z,2018-03-06T18:06:26Z,1636,1633,3,0.001833741,3,4,2,2,"{'LD3': 1, 'LD4': 1}",2,2,"{'LD3': 1, 'LD4': 1}",Bug
2992,7,1.4,2.333333333,2013-09-13T15:09:57Z,2013-09-18T13:14:33Z,5,2,3,0.6,1,3,1,6,{'LD1': 1},1,2,{'LD1': 1},
2993,6,0.1,2,2013-09-13T19:18:30Z,2013-11-12T14:11:20Z,60,57,3,0.05,2,3,3,3,"{'LD4': 1, 'LD1': 1, 'LD5': 1}",2,1,"{'LD4': 1, 'LD1': 1, 'LD5': 1}",
2997,2,0.105263158,1,2013-09-15T10:23:15Z,2013-10-04T10:14:52Z,19,17,2,0.105263158,1,2,1,1,{'LD2': 1},1,1,{'LD2': 1},
2998,20,0.04587156,1.538461538,2013-09-15T13:43:57Z,2014-11-25T04:30:57Z,436,423,13,0.029816514,13,14,14,6,"{'LD4': 1, 'LD3': 6, 'LD1': 6, 'LD2': 1}",10,4,"{'LD4': 1, 'LD3': 6, 'LD1': 4, 'LD2': 1}","Bug,Build system"
3002,7,0.022012579,3.5,2013-09-16T15:25:52Z,2014-07-31T08:11:49Z,318,316,2,0.006289308,2,4,0,7,{},0,4,{},RPC/REST/ZMQ
3003,32,0.066528067,1.882352941,2013-09-16T19:06:39Z,2015-01-10T09:59:35Z,481,464,17,0.035343035,9,12,20,12,"{'LD3': 10, 'LD4': 6, 'LD5': 1, 'LD1': 2, 'LD6': 1}",10,2,"{'LD3': 6, 'LD4': 4, 'LD5': 1, 'LD1': 1, 'LD6': 1}","Bug,Build system"
3004,4,0.090909091,4,2013-09-16T21:28:01Z,2013-10-29T22:41:36Z,44,43,1,0.022727273,1,2,2,2,"{'LD6': 1, 'LD4': 1}",2,0,"{'LD6': 1, 'LD4': 1}",
3006,2,0.068965517,1,2013-09-17T12:42:06Z,2013-10-16T06:48:47Z,29,27,2,0.068965517,3,2,2,0,"{'LD2': 1, 'LD4': 1}",2,0,"{'LD2': 1, 'LD4': 1}",
3013,2,2,2,2013-09-18T13:26:58Z,2013-09-19T10:45:29Z,1,0,1,1,0,2,0,2,{},0,2,{},
3018,2,0.060606061,1,2013-09-19T06:36:27Z,2013-10-21T12:08:36Z,33,31,2,0.060606061,1,2,1,1,{'LD4': 1},1,1,{'LD4': 1},
3030,3,0.027777778,1,2013-09-25T07:17:25Z,2014-01-10T11:59:12Z,108,105,3,0.027777778,3,2,0,3,{},0,2,{},
3033,4,0.037383178,1.333333333,2013-09-26T07:42:34Z,2014-01-10T12:10:52Z,107,104,3,0.028037383,3,3,1,3,{'LD1': 1},1,2,{'LD1': 1},Bug
3036,4,0.333333333,2,2013-09-26T10:21:20Z,2013-10-07T13:32:50Z,12,10,2,0.166666667,3,1,4,0,"{'LD4': 1, 'LD3': 1, 'LD1': 2}",1,0,"{'LD4': 1, 'LD3': 1, 'LD1': 1}",
3037,1,0.090909091,1,2013-09-27T17:05:14Z,2013-10-07T22:42:07Z,11,10,1,0.090909091,2,1,0,1,{},0,1,{},
3049,1,0.5,1,2013-10-02T22:00:51Z,2013-10-04T04:12:48Z,2,1,1,0.5,1,1,1,0,{'LD3': 1},1,0,{'LD3': 1},
3052,1,0.055555556,1,2013-10-04T03:10:07Z,2013-10-21T10:15:30Z,18,17,1,0.055555556,1,1,0,1,{},0,1,{},
3058,2,0.125,1,2013-10-05T11:41:08Z,2013-10-21T10:13:42Z,16,14,2,0.125,1,2,0,2,{},0,2,{},
3062,6,0.013333333,1.5,2013-10-07T04:54:00Z,2014-12-30T12:08:57Z,450,446,4,0.008888889,4,4,3,3,"{'LD3': 2, 'LD5': 1}",3,1,"{'LD3': 2, 'LD5': 1}","Docs,Refactoring"
3063,3,0.010067114,1,2013-10-07T06:48:55Z,2014-07-31T08:09:06Z,298,295,3,0.010067114,3,3,1,2,{'LD4': 1},1,2,{'LD4': 1},"Bug,Build system"
3070,5,0.020746888,1.666666667,2013-10-09T04:43:03Z,2014-06-06T15:30:08Z,241,238,3,0.012448133,4,4,1,4,{'LD4': 1},1,3,{'LD4': 1},"Bug,Build system"
3075,1,0.01010101,1,2013-10-10T13:24:18Z,2014-01-16T15:50:48Z,99,98,1,0.01010101,2,1,1,0,{'LD1': 1},1,0,{'LD1': 1},
3079,1,0.333333333,1,2013-10-11T07:01:07Z,2013-10-14T04:19:36Z,3,2,1,0.333333333,1,1,1,0,{'LD4': 1},1,0,{'LD4': 1},
3090,1,0.066666667,1,2013-10-15T09:31:39Z,2013-10-30T08:03:25Z,15,14,1,0.066666667,1,1,1,0,{'LD3': 1},1,0,{'LD3': 1},Bug
3095,3,0.001414427,1,2013-10-15T14:02:49Z,2019-08-06T06:34:50Z,2121,2118,3,0.001414427,3,2,1,2,{'LD2': 1},1,1,{'LD2': 1},"Brainstorming,GUI"
3100,3,0.375,3,2013-10-16T14:29:13Z,2013-10-24T07:13:18Z,8,7,1,0.125,2,1,3,0,"{'LD4': 2, 'LD3': 1}",1,0,"{'LD4': 1, 'LD3': 1}",GUI
3105,4,4,4,2013-10-17T18:30:23Z,2013-10-17T21:34:28Z,1,0,1,1,0,3,2,2,"{'LD3': 1, 'LD4': 1}",2,1,"{'LD3': 1, 'LD4': 1}",
3107,2,0.666666667,2,2013-10-18T00:00:08Z,2013-10-20T20:30:57Z,3,2,1,0.333333333,1,2,0,2,{},0,2,{},
3111,3,0.014492754,1,2013-10-19T05:03:16Z,2014-05-13T06:46:34Z,207,204,3,0.014492754,3,1,1,2,{'LD2': 1},1,0,{'LD2': 1},Refactoring
3112,2,0.25,1,2013-10-19T06:47:15Z,2013-10-26T07:31:28Z,8,6,2,0.25,1,2,1,1,{'LD4': 1},1,1,{'LD4': 1},Bug
3113,8,0.005438477,1.333333333,2013-10-19T13:12:02Z,2017-10-28T18:55:38Z,1471,1465,6,0.004078858,5,6,1,7,{'LD4': 1},1,5,{'LD4': 1},"Feature,Wallet"
3116,2,0.133333333,1,2013-10-20T00:52:33Z,2013-11-03T00:59:43Z,15,13,2,0.133333333,2,1,0,2,{},0,1,{},
3118,1,0.00173913,1,2013-10-20T10:45:19Z,2015-05-18T09:33:33Z,575,574,1,0.00173913,1,1,1,0,{'LD4': 1},1,0,{'LD4': 1},Bug
3120,2,0.024691358,2,2013-10-21T12:18:01Z,2014-01-10T11:23:03Z,81,80,1,0.012345679,2,2,0,2,{},0,2,{},"Bug,Build system,GUI"
3122,6,0.010452962,2,2013-10-21T23:36:09Z,2015-05-18T17:16:15Z,574,571,3,0.005226481,2,3,3,3,"{'LD4': 1, 'LD3': 1, 'LD5': 1}",1,2,"{'LD4': 1, 'LD3': 1, 'LD5': 1}","Brainstorming,Feature"
3126,2,2,2,2013-10-22T09:28:48Z,2013-10-22T14:27:22Z,1,0,1,1,0,2,0,2,{},0,2,{},
3131,2,1,2,2013-10-22T20:46:54Z,2013-10-24T07:16:41Z,2,1,1,0.5,1,2,1,1,{'LD3': 1},1,1,{'LD3': 1},
3132,9,0.02393617,1.5,2013-10-22T23:06:58Z,2014-11-02T21:46:13Z,376,370,6,0.015957447,4,3,1,8,{'LD6': 1},1,2,{'LD6': 1},"Build system,macOS"
3136,8,0.015473888,1,2013-10-23T13:30:20Z,2015-03-24T07:32:50Z,517,509,8,0.015473888,8,3,2,6,{'LD3': 2},1,2,{'LD3': 1},"Bug,Windows"
3140,3,0.06,1.5,2013-10-24T07:33:01Z,2013-12-12T17:39:01Z,50,48,2,0.04,1,3,1,2,{'LD3': 1},1,2,{'LD3': 1},Refactoring
3141,3,0.00209205,1.5,2013-10-24T08:57:29Z,2017-09-26T22:00:43Z,1434,1432,2,0.0013947,1,3,1,2,{'LD5': 1},1,2,{'LD5': 1},"Feature,GUI,Wallet"
3142,5,0.416666667,1.666666667,2013-10-24T09:02:10Z,2013-11-04T14:09:12Z,12,9,3,0.25,2,2,3,2,"{'LD1': 1, 'LD4': 1, 'LD5': 1}",2,0,"{'LD1': 1, 'LD4': 1, 'LD5': 1}",
3156,1,0.333333333,1,2013-10-26T11:08:31Z,2013-10-28T15:34:43Z,3,2,1,0.333333333,1,1,0,1,{},0,1,{},
3166,3,0.004291845,1,2013-10-27T10:30:47Z,2015-09-25T17:19:26Z,699,696,3,0.004291845,3,3,1,2,{'LD4': 1},1,2,{'LD4': 1},Refactoring
3168,4,0.025806452,1.333333333,2013-10-27T16:36:27Z,2014-03-31T09:32:16Z,155,152,3,0.019354839,2,3,0,4,{},0,3,{},Refactoring
3171,8,0.00464846,2,2013-10-28T04:55:11Z,2018-07-14T17:15:16Z,1721,1717,4,0.00232423,3,5,5,3,"{'LD6': 2, 'LD4': 3}",4,1,"{'LD6': 2, 'LD4': 3}","Tests,good first issue"
3172,4,0.00268998,1,2013-10-28T05:05:20Z,2017-11-22T15:39:32Z,1487,1483,4,0.00268998,2,4,2,2,{'LD4': 2},2,2,{'LD4': 2},"Tests,good first issue"
3181,5,0.002097315,2.5,2013-10-29T03:00:04Z,2020-05-08T17:52:58Z,2384,2382,2,0.000838926,2,4,2,3,"{'LD3': 1, 'LD4': 1}",2,2,"{'LD3': 1, 'LD4': 1}",Brainstorming
3182,13,0.030444965,1.857142857,2013-10-29T04:36:07Z,2014-12-29T09:01:11Z,427,420,7,0.016393443,7,8,4,9,"{'LD1': 1, 'LD4': 2, 'LD3': 1}",4,4,"{'LD1': 1, 'LD4': 2, 'LD3': 1}","Feature,macOS"
3186,1,0.0625,1,2013-10-30T08:28:55Z,2013-11-14T20:18:01Z,16,15,1,0.0625,2,1,0,1,{},0,1,{},Bug
3190,9,0.257142857,3,2013-11-01T02:07:07Z,2013-12-05T07:18:59Z,35,32,3,0.085714286,2,4,1,8,{'LD4': 1},1,3,{'LD4': 1},
3194,2,0.011049724,1,2013-11-03T09:52:57Z,2014-05-02T18:17:49Z,181,179,2,0.011049724,1,2,1,1,{'LD1': 1},1,1,{'LD1': 1},Windows
3195,23,0.014420063,1.642857143,2013-11-04T03:31:43Z,2018-03-17T16:28:52Z,1595,1581,14,0.008777429,13,10,6,17,"{'LD4': 4, 'LD5': 1, 'LD1': 1}",4,6,"{'LD4': 4, 'LD5': 1, 'LD1': 1}","Brainstorming,P2P"
3201,1,0.000631712,1,2013-11-05T06:01:47Z,2018-03-06T21:51:48Z,1583,1582,1,0.000631712,1,1,0,1,{},0,1,{},Brainstorming
3202,2,0.25,2,2013-11-05T12:36:26Z,2013-11-12T15:49:22Z,8,7,1,0.125,1,1,1,1,{'LD3': 1},1,0,{'LD3': 1},"GUI,Refactoring"
3203,19,0.106741573,2.111111111,2013-11-05T12:54:19Z,2014-05-02T07:46:54Z,178,169,9,0.050561798,5,9,2,17,"{'LD3': 1, 'LD1': 1}",2,7,"{'LD3': 1, 'LD1': 1}",Refactoring
3212,3,0.00127011,1.5,2013-11-06T05:26:28Z,2020-04-24T20:06:00Z,2362,2360,2,0.00084674,2,2,0,3,{},0,2,{},"Feature,Wallet"
3214,4,0.02259887,1.333333333,2013-11-06T11:19:32Z,2014-05-02T07:43:26Z,177,174,3,0.016949153,2,4,0,4,{},0,4,{},Refactoring
3216,2,2,2,2013-11-07T03:22:11Z,2013-11-07T07:32:39Z,1,0,1,1,0,1,0,2,{},0,1,{},"Bug,GUI"
3218,13,0.005473684,2.166666667,2013-11-07T07:59:43Z,2020-05-08T17:53:40Z,2375,2369,6,0.002526316,5,6,6,7,"{'LD5': 2, 'LD3': 1, 'LD4': 2, 'LD1': 1}",5,1,"{'LD5': 2, 'LD3': 1, 'LD4': 2, 'LD1': 1}",Bug
3219,24,0.084210526,3,2013-11-07T16:14:52Z,2014-08-18T18:18:07Z,285,277,8,0.028070175,7,7,11,13,"{'LD4': 2, 'LD5': 1, 'LD3': 6, 'LD1': 2}",5,2,"{'LD4': 2, 'LD5': 1, 'LD3': 4, 'LD1': 2}",Build system
3220,20,0.01039501,2,2013-11-07T16:26:21Z,2019-02-12T23:33:24Z,1924,1914,10,0.005197505,8,9,5,15,"{'LD4': 3, 'LD3': 1, 'LD5': 1}",4,5,"{'LD4': 3, 'LD3': 1, 'LD5': 1}",Brainstorming
3224,10,0.057142857,3.333333333,2013-11-08T23:33:23Z,2014-05-02T18:17:15Z,175,172,3,0.017142857,3,5,1,9,{'LD3': 1},1,4,{'LD3': 1},Docs
3225,4,0.057142857,2,2013-11-09T01:57:43Z,2014-01-17T16:10:39Z,70,68,2,0.028571429,2,2,1,3,{'LD2': 1},1,1,{'LD2': 1},
3226,45,0.020408163,1.956521739,2013-11-09T12:27:51Z,2019-11-22T20:01:55Z,2205,2182,23,0.010430839,14,16,12,33,"{'LD3': 5, 'LD4': 4, 'LD1': 2, 'LD2': 1}",9,7,"{'LD3': 3, 'LD4': 4, 'LD1': 2, 'LD2': 1}","Feature,Privacy,Wallet"
3227,2,0.028985507,2,2013-11-09T20:57:05Z,2014-01-17T12:21:35Z,69,68,1,0.014492754,1,2,0,2,{},0,2,{},
3228,32,0.076923077,1.523809524,2013-11-10T06:03:14Z,2014-12-30T14:38:48Z,416,395,21,0.050480769,19,21,20,12,"{'LD4': 7, 'LD2': 1, 'LD1': 5, 'LD3': 6, 'LD5': 1}",16,5,"{'LD4': 6, 'LD2': 1, 'LD1': 4, 'LD3': 6, 'LD5': 1}","Build system,macOS"
3230,2,2,2,2013-11-11T00:19:21Z,2013-11-11T12:42:48Z,1,0,1,1,0,2,1,1,{'LD1': 1},1,1,{'LD1': 1},
3236,6,3,6,2013-11-11T17:21:49Z,2013-11-13T08:30:47Z,2,1,1,0.5,1,2,2,4,"{'LD1': 1, 'LD4': 1}",1,1,"{'LD1': 1, 'LD4': 1}",
3243,1,0.016949153,1,2013-11-13T09:43:09Z,2014-01-10T12:09:45Z,59,58,1,0.016949153,1,1,1,0,{'LD1': 1},1,0,{'LD1': 1},
3245,1,0.25,1,2013-11-13T12:22:52Z,2013-11-16T13:30:06Z,4,3,1,0.25,2,1,0,1,{},0,1,{},"Bug,Tests,Windows"
3249,12,0.046332046,2.4,2013-11-14T09:35:38Z,2014-07-31T08:08:27Z,259,254,5,0.019305019,3,5,5,7,"{'LD3': 1, 'LD5': 2, 'LD4': 2}",4,1,"{'LD3': 1, 'LD5': 1, 'LD4': 2}",
3250,14,0.014783527,2,2013-11-14T11:57:17Z,2016-06-18T07:27:28Z,947,940,7,0.007391763,6,9,4,10,"{'LD1': 3, 'LD3': 1}",3,6,"{'LD1': 2, 'LD3': 1}","Feature,Wallet"
3256,2,0.011363636,1,2013-11-14T19:08:54Z,2014-05-09T08:17:08Z,176,174,2,0.011363636,1,2,2,0,"{'LD3': 1, 'LD5': 1}",2,0,"{'LD3': 1, 'LD5': 1}",Refactoring
3269,2,0.00191022,1,2013-11-16T17:05:54Z,2016-09-27T19:55:04Z,1047,1045,2,0.00191022,3,2,1,1,{'LD4': 1},1,1,{'LD4': 1},"GUI,Wallet"
3270,1,0.043478261,1,2013-11-16T21:42:22Z,2013-12-09T15:51:32Z,23,22,1,0.043478261,1,1,0,1,{},0,1,{},
3274,12,0.032171582,4,2013-11-17T21:20:32Z,2014-11-25T04:27:27Z,373,370,3,0.008042895,3,3,5,7,"{'LD2': 1, 'LD3': 1, 'LD4': 3}",3,0,"{'LD2': 1, 'LD3': 1, 'LD4': 2}","Bug,Build system"
3280,1,1,1,2013-11-19T11:11:55Z,2013-11-20T06:44:57Z,1,0,1,1,0,1,0,1,{},0,1,{},
3282,10,0.038314176,1.666666667,2013-11-20T05:44:55Z,2014-08-07T05:58:24Z,261,255,6,0.022988506,3,3,5,5,"{'LD1': 2, 'LD5': 1, 'LD4': 2}",3,0,"{'LD1': 2, 'LD5': 1, 'LD4': 1}","GUI,Refactoring,Windows"
3288,6,6,6,2013-11-20T17:06:00Z,2013-11-20T22:50:10Z,1,0,1,1,0,2,3,3,"{'LD4': 2, 'LD5': 1}",2,0,"{'LD4': 1, 'LD5': 1}",
3289,2,0.03030303,1,2013-11-20T17:57:30Z,2014-01-25T10:29:03Z,66,64,2,0.03030303,2,2,0,2,{},0,2,{},Bug
3290,3,0.017964072,1.5,2013-11-20T18:11:05Z,2014-05-06T09:30:03Z,167,165,2,0.011976048,2,2,0,3,{},0,2,{},macOS
3292,14,0.034653465,2.333333333,2013-11-20T21:12:34Z,2014-12-29T09:03:24Z,404,398,6,0.014851485,5,5,2,12,"{'LD3': 1, 'LD5': 1}",2,3,"{'LD3': 1, 'LD5': 1}","GUI,Refactoring,macOS"
3298,2,0.001919386,2,2013-11-21T17:55:00Z,2016-09-28T08:00:47Z,1042,1041,1,0.000959693,2,1,0,2,{},0,1,{},RPC/REST/ZMQ
3303,7,0.012915129,1.75,2013-11-22T10:54:39Z,2015-05-18T09:29:21Z,542,538,4,0.007380074,3,5,0,7,{},0,5,{},"RPC/REST/ZMQ,Refactoring"
3304,5,0.071428571,1.25,2013-11-22T10:54:58Z,2014-01-30T11:07:37Z,70,66,4,0.057142857,2,4,1,4,{'LD4': 1},1,3,{'LD4': 1},"GUI,Refactoring"
3307,7,0.388888889,1.4,2013-11-22T14:57:10Z,2013-12-10T08:40:47Z,18,13,5,0.277777778,3,3,3,4,"{'LD3': 2, 'LD4': 1}",3,0,"{'LD3': 2, 'LD4': 1}",Build system
3308,2,0.007968127,1,2013-11-22T21:43:02Z,2014-07-31T08:11:14Z,251,249,2,0.007968127,2,1,1,1,{'LD2': 1},1,0,{'LD2': 1},
3313,5,0.014749263,5,2013-11-24T05:27:55Z,2014-10-28T18:46:26Z,339,338,1,0.002949853,2,3,1,4,{'LD4': 1},1,2,{'LD4': 1},Brainstorming
3315,5,0.625,5,2013-11-25T19:35:33Z,2013-12-03T11:56:49Z,8,7,1,0.125,2,4,1,4,{'LD6': 1},1,3,{'LD6': 1},"GUI,Refactoring"
3317,1,0.018867925,1,2013-11-26T11:51:01Z,2014-01-17T16:00:50Z,53,52,1,0.018867925,1,1,0,1,{},0,1,{},"Bug,macOS"
3323,2,0.2,1,2013-11-28T07:42:21Z,2013-12-07T10:58:24Z,10,8,2,0.2,2,2,0,2,{},0,2,{},
3324,3,0.01875,1.5,2013-11-28T08:19:43Z,2014-05-06T09:35:48Z,160,158,2,0.0125,2,2,1,2,{'LD3': 1},1,1,{'LD3': 1},
3333,3,0.065217391,1.5,2013-11-30T05:00:37Z,2014-01-14T17:59:13Z,46,44,2,0.043478261,2,2,0,3,{},0,2,{},"Bug,Wallet"
3334,4,0.444444444,1.333333333,2013-11-30T15:57:37Z,2013-12-09T04:27:38Z,9,6,3,0.333333333,2,3,1,3,{'LD4': 1},1,2,{'LD4': 1},
3337,2,0.000855066,2,2013-12-01T08:59:08Z,2020-04-27T00:10:07Z,2339,2338,1,0.000427533,1,1,1,1,{'LD3': 1},1,0,{'LD3': 1},Feature
3351,3,0.75,3,2013-12-03T16:33:46Z,2013-12-07T10:57:44Z,4,3,1,0.25,1,2,1,2,{'LD2': 1},1,1,{'LD2': 1},
3358,1,0.142857143,1,2013-12-05T07:10:07Z,2013-12-12T00:01:54Z,7,6,1,0.142857143,1,1,1,0,{'LD6': 1},1,0,{'LD6': 1},"Build system,macOS"
3363,5,1.25,1.25,2013-12-06T02:27:08Z,2013-12-09T07:25:48Z,4,0,4,1,0,2,3,2,"{'LD3': 1, 'LD1': 2}",1,1,"{'LD3': 1, 'LD1': 1}","Build system,macOS"
3364,5,1.666666667,1.666666667,2013-12-06T13:28:01Z,2013-12-09T09:05:03Z,3,0,3,1,0,3,3,2,"{'LD4': 2, 'LD1': 1}",1,2,"{'LD4': 1, 'LD1': 1}",GUI
3371,3,3,3,2013-12-08T23:47:13Z,2013-12-09T07:24:04Z,1,0,1,1,0,2,2,1,"{'LD4': 1, 'LD5': 1}",2,0,"{'LD4': 1, 'LD5': 1}",
3376,3,0.031914894,1,2013-12-09T23:51:03Z,2014-03-13T09:56:15Z,94,91,3,0.031914894,2,3,2,1,"{'LD4': 1, 'LD2': 1}",2,1,"{'LD4': 1, 'LD2': 1}",Bug
3384,3,0.012875536,3,2013-12-10T19:23:39Z,2014-07-31T07:07:02Z,233,232,1,0.004291845,2,1,0,3,{},0,1,{},"Bug,GUI"
3386,1,1,1,2013-12-10T21:10:33Z,2013-12-11T06:31:39Z,1,0,1,1,0,1,0,1,{},0,1,{},
3388,9,0.063829787,1.8,2013-12-11T00:59:26Z,2014-04-30T17:22:10Z,141,136,5,0.035460993,4,2,5,4,"{'LD4': 1, 'LD3': 2, 'LD1': 1, 'LD6': 1}",2,0,"{'LD4': 1, 'LD3': 1, 'LD1': 1, 'LD6': 1}",Refactoring
3396,2,0.005221932,1,2013-12-12T01:07:09Z,2014-12-29T08:58:13Z,383,381,2,0.005221932,2,1,1,1,{'LD4': 1},1,0,{'LD4': 1},"Tests,macOS"
3398,3,0.1,1.5,2013-12-12T05:09:39Z,2014-01-10T12:23:04Z,30,28,2,0.066666667,1,2,0,3,{},0,2,{},Docs
3406,7,1,3.5,2013-12-12T23:59:11Z,2013-12-19T09:11:27Z,7,5,2,0.285714286,1,2,0,7,{},0,2,{},
3410,9,0.017274472,3,2013-12-13T09:56:51Z,2015-05-18T08:42:35Z,521,518,3,0.005758157,3,4,4,5,"{'LD4': 2, 'LD3': 2}",2,2,"{'LD4': 2, 'LD3': 1}",P2P
3414,4,1.333333333,4,2013-12-13T20:38:50Z,2013-12-16T18:33:32Z,3,2,1,0.333333333,1,3,2,2,"{'LD2': 1, 'LD4': 1}",2,1,"{'LD2': 1, 'LD4': 1}",
3428,3,3,3,2013-12-16T19:41:45Z,2013-12-17T12:12:21Z,1,0,1,1,0,2,0,3,{},0,2,{},Docs
3440,6,0.007653061,3,2013-12-18T13:42:54Z,2016-02-09T16:23:24Z,784,782,2,0.00255102,2,5,1,5,{'LD3': 1},1,4,{'LD3': 1},"Brainstorming,Refactoring"
3443,2,0.095238095,1,2013-12-18T21:22:46Z,2014-01-08T20:18:21Z,21,19,2,0.095238095,2,1,0,2,{},0,1,{},
3444,1,1,1,2013-12-19T07:39:42Z,2013-12-19T09:37:11Z,1,0,1,1,0,1,1,0,{'LD1': 1},1,0,{'LD1': 1},
3445,1,0.5,1,2013-12-19T09:29:22Z,2013-12-21T09:22:06Z,2,1,1,0.5,1,1,1,0,{'LD3': 1},1,0,{'LD3': 1},Tests
3455,3,0.001276053,1,2013-12-22T12:32:21Z,2020-05-29T12:43:10Z,2351,2348,3,0.001276053,4,3,2,1,{'LD3': 2},2,1,{'LD3': 2},"Bug,GUI"
3456,5,0.009765625,2.5,2013-12-23T03:51:57Z,2015-05-18T11:22:53Z,512,510,2,0.00390625,2,2,3,2,"{'LD4': 1, 'LD1': 1, 'LD3': 1}",1,1,"{'LD4': 1, 'LD1': 1, 'LD3': 1}",Bug
3459,3,0.00128866,1,2013-12-24T09:34:04Z,2020-05-08T18:01:51Z,2328,2325,3,0.00128866,3,2,1,2,{'LD3': 1},1,1,{'LD3': 1},"Docs,Feature,macOS"
3464,2,2,2,2013-12-26T18:06:23Z,2013-12-27T02:08:38Z,1,0,1,1,0,1,2,0,"{'LD1': 1, 'LD3': 1}",1,0,"{'LD1': 1, 'LD3': 1}",
3465,1,0.000693963,1,2013-12-27T01:16:44Z,2017-12-06T21:58:26Z,1441,1440,1,0.000693963,1,1,1,0,{'LD3': 1},1,0,{'LD3': 1},"Brainstorming,Refactoring"
3466,1,0.083333333,1,2013-12-28T02:36:23Z,2014-01-08T17:17:25Z,12,11,1,0.083333333,2,1,1,0,{'LD4': 1},1,0,{'LD4': 1},
3470,3,0.001960784,1,2013-12-28T15:21:33Z,2018-03-07T07:36:03Z,1530,1527,3,0.001960784,4,3,1,2,{'LD2': 1},1,2,{'LD2': 1},GUI
3471,9,0.1,1.8,2013-12-29T05:38:32Z,2014-03-29T05:00:07Z,90,85,5,0.055555556,3,4,2,7,"{'LD1': 1, 'LD2': 1}",2,2,"{'LD1': 1, 'LD2': 1}",Build system
3477,2,1,2,2013-12-30T17:41:51Z,2014-01-01T09:00:12Z,2,1,1,0.5,1,2,2,0,{'LD1': 2},2,0,{'LD1': 2},
3478,1,0.076923077,1,2014-01-01T02:55:41Z,2014-01-13T16:30:14Z,13,12,1,0.076923077,2,1,0,1,{},0,1,{},"Bug,GUI"
3483,2,0.005420054,1,2014-01-03T03:24:02Z,2015-01-06T19:32:59Z,369,367,2,0.005420054,2,2,1,1,{'LD3': 1},1,1,{'LD3': 1},Build system
3484,2,0.00486618,2,2014-01-03T20:55:57Z,2015-02-18T16:23:34Z,411,410,1,0.00243309,1,2,1,1,{'LD4': 1},1,1,{'LD4': 1},Windows
3485,4,0.571428571,1.333333333,2014-01-03T21:57:44Z,2014-01-10T07:55:17Z,7,4,3,0.428571429,1,2,0,4,{},0,2,{},
3487,2,1,2,2014-01-05T10:28:42Z,2014-01-07T09:29:36Z,2,1,1,0.5,1,1,2,0,"{'LD1': 1, 'LD4': 1}",1,0,"{'LD1': 1, 'LD4': 1}",
3494,4,2,2,2014-01-07T17:46:22Z,2014-01-09T08:58:22Z,2,0,2,1,0,4,1,3,{'LD3': 1},1,3,{'LD3': 1},"Bug,Windows"
3495,1,0.002457002,1,2014-01-08T00:08:22Z,2015-02-18T16:24:10Z,407,406,1,0.002457002,1,1,1,0,{'LD2': 1},1,0,{'LD2': 1},Bug
3496,4,0.008064516,2,2014-01-08T07:48:15Z,2015-05-18T11:16:27Z,496,494,2,0.004032258,2,1,2,2,"{'LD1': 1, 'LD4': 1}",1,0,"{'LD1': 1, 'LD4': 1}",Bug
3499,13,0.684210526,2.166666667,2014-01-09T13:07:09Z,2014-01-28T08:40:18Z,19,13,6,0.315789474,4,4,6,7,"{'LD4': 4, 'LD3': 1, 'LD1': 1}",3,1,"{'LD4': 3, 'LD3': 1, 'LD1': 1}",Build system
3508,1,1,1,2014-01-10T23:36:23Z,2014-01-11T00:02:20Z,1,0,1,1,0,1,0,1,{},0,1,{},
3515,5,2.5,2.5,2014-01-11T20:00:52Z,2014-01-13T08:01:11Z,2,0,2,1,0,3,3,2,"{'LD5': 1, 'LD4': 1, 'LD3': 1}",2,1,"{'LD5': 1, 'LD4': 1, 'LD3': 1}",
3519,3,1.5,3,2014-01-12T20:50:34Z,2014-01-14T05:18:27Z,2,1,1,0.5,1,2,1,2,{'LD1': 1},1,1,{'LD1': 1},
3522,1,0.333333333,1,2014-01-13T08:39:20Z,2014-01-15T12:20:58Z,3,2,1,0.333333333,1,1,0,1,{},0,1,{},"Bug,Build system"
3529,13,1.181818182,6.5,2014-01-13T16:34:21Z,2014-01-24T12:16:30Z,11,9,2,0.181818182,1,7,3,10,"{'LD4': 1, 'LD6': 1, 'LD3': 1}",2,5,"{'LD4': 1, 'LD6': 1, 'LD3': 1}",Bug
3530,4,0.666666667,2,2014-01-13T16:36:35Z,2014-01-18T23:34:00Z,6,4,2,0.333333333,2,2,1,3,{'LD3': 1},1,1,{'LD3': 1},Refactoring
3531,2,0.025641026,1,2014-01-13T16:37:42Z,2014-04-01T15:15:18Z,78,76,2,0.025641026,2,2,0,2,{},0,2,{},Refactoring
3533,7,3.5,7,2014-01-13T16:39:08Z,2014-01-15T13:33:38Z,2,1,1,0.5,1,4,4,3,"{'LD3': 2, 'LD4': 2}",3,1,"{'LD3': 2, 'LD4': 2}","Build system,Refactoring"
3535,2,0.5,2,2014-01-14T04:32:54Z,2014-01-17T16:44:48Z,4,3,1,0.25,1,1,0,2,{},0,1,{},"Build system,Windows"
3539,2,0.001639344,1,2014-01-14T16:50:56Z,2017-05-18T12:48:50Z,1220,1218,2,0.001639344,2,2,0,2,{},0,2,{},Build system
3543,2,0.019047619,2,2014-01-14T23:02:14Z,2014-04-29T12:53:09Z,105,104,1,0.00952381,1,1,1,1,{'LD4': 1},1,0,{'LD4': 1},
3544,4,0.5,2,2014-01-15T13:31:58Z,2014-01-23T07:26:17Z,8,6,2,0.25,1,3,2,2,"{'LD3': 1, 'LD4': 1}",2,1,"{'LD3': 1, 'LD4': 1}",Build system
3550,12,0.034482759,2,2014-01-17T04:09:57Z,2014-12-30T14:38:24Z,348,342,6,0.017241379,5,6,4,8,"{'LD1': 2, 'LD4': 2}",3,3,"{'LD1': 2, 'LD4': 1}","Build system,macOS"
3552,1,1,1,2014-01-17T15:06:34Z,2014-01-17T15:24:44Z,1,0,1,1,0,1,1,0,{'LD1': 1},1,0,{'LD1': 1},
3558,3,3,3,2014-01-19T13:48:12Z,2014-01-19T16:47:29Z,1,0,1,1,0,1,1,2,{'LD1': 1},1,0,{'LD1': 1},
3561,2,1,1,2014-01-20T20:36:14Z,2014-01-22T19:40:43Z,2,0,2,1,0,2,1,1,{'LD3': 1},1,1,{'LD3': 1},
3562,1,1,1,2014-01-20T22:57:03Z,2014-01-21T06:57:18Z,1,0,1,1,0,1,1,0,{'LD1': 1},1,0,{'LD1': 1},
3563,3,0.018867925,1,2014-01-21T04:22:35Z,2014-06-28T13:21:53Z,159,156,3,0.018867925,2,2,1,2,{'LD3': 1},1,1,{'LD3': 1},"Bug,macOS"
3566,4,0.017621145,1,2014-01-21T18:33:35Z,2014-09-05T15:09:44Z,227,223,4,0.017621145,4,4,3,1,{'LD3': 3},3,1,{'LD3': 3},Brainstorming
3575,7,0.21875,2.333333333,2014-01-23T01:04:35Z,2014-02-23T23:22:59Z,32,29,3,0.09375,3,4,2,5,"{'LD4': 1, 'LD6': 1}",2,2,"{'LD4': 1, 'LD6': 1}",
3581,3,0.6,3,2014-01-24T21:59:59Z,2014-01-29T13:47:11Z,5,4,1,0.2,2,1,0,3,{},0,1,{},Bug
3596,2,0.004210526,1,2014-01-28T18:56:58Z,2015-05-18T08:40:32Z,475,473,2,0.004210526,3,2,0,2,{},0,2,{},UTXO Db and Indexes
3607,1,0.005291005,1,2014-01-31T08:58:11Z,2014-08-07T10:48:20Z,189,188,1,0.005291005,2,1,0,1,{},0,1,{},"Build system,Windows"
3610,7,1.75,3.5,2014-01-31T14:33:59Z,2014-02-03T17:59:50Z,4,2,2,0.5,1,4,2,5,"{'LD4': 1, 'LD6': 1}",2,2,"{'LD4': 1, 'LD6': 1}","Bug,Build system"
3611,4,0.010810811,1,2014-02-01T00:12:37Z,2015-02-05T13:18:58Z,370,366,4,0.010810811,3,3,2,2,"{'LD4': 1, 'LD5': 1}",2,1,"{'LD4': 1, 'LD5': 1}",macOS
3612,6,0.285714286,3,2014-02-01T17:39:42Z,2014-02-22T08:57:48Z,21,19,2,0.095238095,1,2,2,4,"{'LD3': 1, 'LD4': 1}",2,0,"{'LD3': 1, 'LD4': 1}","Bug,Build system"
3617,1,0.066666667,1,2014-02-02T13:11:15Z,2014-02-17T11:30:53Z,15,14,1,0.066666667,1,1,1,0,{'LD1': 1},1,0,{'LD1': 1},
3618,9,0.003933566,3,2014-02-02T17:20:07Z,2020-05-08T18:03:35Z,2288,2285,3,0.001311189,3,5,4,5,"{'LD3': 1, 'LD1': 2, 'LD2': 1}",4,1,"{'LD3': 1, 'LD1': 2, 'LD2': 1}","Feature,Windows"
3624,2,2,2,2014-02-04T13:09:34Z,2014-02-04T16:05:08Z,1,0,1,1,0,2,1,1,{'LD2': 1},1,1,{'LD2': 1},
3628,3,0.006423983,1.5,2014-02-05T14:38:23Z,2015-05-18T11:15:40Z,467,465,2,0.004282655,2,2,0,3,{},0,2,{},"Bug,GUI"
3629,2,0.105263158,1,2014-02-05T17:25:51Z,2014-02-24T17:22:44Z,19,17,2,0.105263158,2,2,1,1,{'LD5': 1},1,1,{'LD5': 1},
3630,2,0.5,2,2014-02-05T17:51:14Z,2014-02-08T19:49:12Z,4,3,1,0.25,1,2,1,1,{'LD4': 1},1,1,{'LD4': 1},
3631,1,0.001349528,1,2014-02-05T17:53:03Z,2016-02-16T15:17:02Z,741,740,1,0.001349528,2,1,0,1,{},0,1,{},"Bug,Wallet"
3639,2,0.006779661,1,2014-02-07T14:40:30Z,2014-11-29T10:03:10Z,295,293,2,0.006779661,1,2,2,0,"{'LD6': 1, 'LD5': 1}",2,0,"{'LD6': 1, 'LD5': 1}",Bug
3641,2,0.105263158,2,2014-02-07T18:18:57Z,2014-02-25T20:45:18Z,19,18,1,0.052631579,2,2,0,2,{},0,2,{},
3658,3,0.5,3,2014-02-12T10:28:43Z,2014-02-18T07:40:40Z,6,5,1,0.166666667,1,3,1,2,{'LD1': 1},1,2,{'LD1': 1},"Mining,Questions and Help"
3664,10,0.303030303,2.5,2014-02-13T09:55:34Z,2014-03-18T09:40:23Z,33,29,4,0.121212121,3,4,1,9,{'LD1': 1},1,3,{'LD1': 1},
3665,3,0.003963012,1,2014-02-13T11:48:36Z,2016-03-11T09:08:08Z,757,754,3,0.003963012,2,3,2,1,"{'LD3': 1, 'LD2': 1}",2,1,"{'LD3': 1, 'LD2': 1}","Bug,GUI"
3670,2,0.5,2,2014-02-14T01:05:46Z,2014-02-17T10:50:34Z,4,3,1,0.25,1,1,1,1,{'LD3': 1},1,0,{'LD3': 1},Bug
3673,1,0.001042753,1,2014-02-14T11:58:21Z,2016-09-29T15:20:17Z,959,958,1,0.001042753,2,1,0,1,{},0,1,{},"Bug,Wallet"
3677,2,1,2,2014-02-15T11:35:16Z,2014-02-17T11:09:23Z,2,1,1,0.5,1,1,1,1,{'LD1': 1},1,0,{'LD1': 1},GUI
3689,2,2,2,2014-02-17T03:43:59Z,2014-02-17T07:41:25Z,1,0,1,1,0,2,0,2,{},0,2,{},
3697,1,1,1,2014-02-18T01:45:27Z,2014-02-18T17:28:16Z,1,0,1,1,0,1,0,1,{},0,1,{},
3702,3,3,3,2014-02-18T15:42:23Z,2014-02-19T08:04:14Z,1,0,1,1,0,3,0,3,{},0,3,{},Bug
3710,5,2.5,2.5,2014-02-20T12:07:28Z,2014-02-22T08:51:31Z,2,0,2,1,0,3,2,3,{'LD3': 2},2,1,{'LD3': 2},Brainstorming
3721,10,3.333333333,10,2014-02-21T16:36:51Z,2014-02-24T16:05:50Z,3,2,1,0.333333333,1,5,3,7,"{'LD4': 2, 'LD1': 1}",3,2,"{'LD4': 2, 'LD1': 1}",
3722,5,0.005263158,1.25,2014-02-21T17:01:06Z,2016-09-27T19:52:49Z,950,946,4,0.004210526,3,3,1,4,{'LD4': 1},1,2,{'LD4': 1},"Brainstorming,Refactoring"
3723,5,0.005263158,1.666666667,2014-02-21T17:33:06Z,2016-09-27T19:49:46Z,950,947,3,0.003157895,2,3,2,3,{'LD4': 2},1,2,{'LD4': 1},"Brainstorming,Mempool"
3725,11,2.75,3.666666667,2014-02-21T19:25:01Z,2014-02-25T16:34:20Z,4,1,3,0.75,1,1,6,5,"{'LD4': 2, 'LD6': 1, 'LD3': 1, 'LD1': 2}",1,0,"{'LD4': 1, 'LD6': 1, 'LD3': 1, 'LD1': 1}",Docs
3734,1,1,1,2014-02-23T21:23:32Z,2014-02-24T01:35:56Z,1,0,1,1,0,1,0,1,{},0,1,{},
3746,2,0.285714286,1,2014-02-25T20:15:24Z,2014-03-04T09:49:49Z,7,5,2,0.285714286,1,2,0,2,{},0,2,{},
3748,2,0.03030303,2,2014-02-26T11:55:02Z,2014-05-02T17:51:42Z,66,65,1,0.015151515,1,1,1,1,{'LD1': 1},1,0,{'LD1': 1},
3754,6,0.024590164,1.2,2014-02-27T04:57:23Z,2014-10-28T18:49:54Z,244,239,5,0.020491803,3,4,4,2,"{'LD4': 1, 'LD2': 1, 'LD1': 1, 'LD5': 1}",4,0,"{'LD4': 1, 'LD2': 1, 'LD1': 1, 'LD5': 1}",Brainstorming
3756,1,0.003154574,1,2014-02-27T05:55:19Z,2015-01-09T21:58:13Z,317,316,1,0.003154574,2,1,1,0,{'LD5': 1},1,0,{'LD5': 1},
3757,2,0.021052632,2,2014-02-27T05:58:04Z,2014-06-01T08:16:21Z,95,94,1,0.010526316,1,2,0,2,{},0,2,{},
3766,2,2,2,2014-02-28T00:23:31Z,2014-02-28T18:36:40Z,1,0,1,1,0,1,1,1,{'LD4': 1},1,0,{'LD4': 1},Build system
3770,2,0.027027027,2,2014-02-28T23:08:17Z,2014-05-13T06:57:36Z,74,73,1,0.013513514,1,2,0,2,{},0,2,{},
3772,2,0.009049774,1,2014-03-01T01:48:09Z,2014-10-07T07:37:46Z,221,219,2,0.009049774,2,1,0,2,{},0,1,{},Build system
3774,1,0.000968992,1,2014-03-01T18:32:22Z,2016-12-27T16:05:50Z,1032,1031,1,0.000968992,2,1,0,1,{},0,1,{},P2P
3776,2,0.02739726,1,2014-03-02T00:03:53Z,2014-05-13T06:57:18Z,73,71,2,0.02739726,2,2,0,2,{},0,2,{},
3777,1,1,1,2014-03-02T09:10:44Z,2014-03-02T09:55:55Z,1,0,1,1,0,1,0,1,{},0,1,{},
3778,8,0.666666667,2,2014-03-02T14:06:40Z,2014-03-14T01:01:10Z,12,8,4,0.333333333,3,6,1,7,{'LD4': 1},1,5,{'LD4': 1},Bug
3779,2,2,2,2014-03-02T16:06:02Z,2014-03-03T13:27:11Z,1,0,1,1,0,2,1,1,{'LD1': 1},1,1,{'LD1': 1},
3781,8,0.131147541,4,2014-03-02T18:27:35Z,2014-05-02T17:49:55Z,61,59,2,0.032786885,1,3,5,3,"{'LD4': 1, 'LD3': 3, 'LD5': 1}",2,1,"{'LD4': 1, 'LD3': 1, 'LD5': 1}",
3782,2,0.2,1,2014-03-03T00:04:53Z,2014-03-12T15:31:16Z,10,8,2,0.2,1,2,0,2,{},0,2,{},
3785,1,0.142857143,1,2014-03-03T17:07:32Z,2014-03-10T08:21:08Z,7,6,1,0.142857143,1,1,0,1,{},0,1,{},
3789,1,0.006666667,1,2014-03-03T21:22:26Z,2014-07-31T08:02:46Z,150,149,1,0.006666667,1,1,1,0,{'LD1': 1},1,0,{'LD1': 1},
3790,1,1,1,2014-03-03T22:12:57Z,2014-03-04T01:27:26Z,1,0,1,1,0,1,1,0,{'LD5': 1},1,0,{'LD5': 1},
3791,7,0.003100089,7,2014-03-03T23:49:32Z,2020-05-08T23:47:40Z,2258,2257,1,0.00044287,1,3,2,5,"{'LD1': 1, 'LD3': 1}",1,2,"{'LD1': 1, 'LD3': 1}",Wallet
3794,8,0.011188811,4,2014-03-04T15:13:09Z,2016-02-16T15:13:17Z,715,713,2,0.002797203,2,6,1,7,{'LD3': 1},1,5,{'LD3': 1},"Feature,Wallet"
3795,3,0.006818182,1.5,2014-03-04T15:14:54Z,2015-05-18T11:13:38Z,440,438,2,0.004545455,2,2,0,3,{},0,2,{},Wallet
3800,1,0.5,1,2014-03-05T06:59:39Z,2014-03-06T13:58:11Z,2,1,1,0.5,1,1,0,1,{},0,1,{},
3802,24,0.010633584,1.846153846,2014-03-05T12:16:15Z,2020-05-08T18:06:46Z,2257,2244,13,0.005759858,12,9,6,18,"{'LD4': 2, 'LD3': 2, 'LD1': 2}",3,6,"{'LD4': 2, 'LD3': 1, 'LD1': 2}","Feature,P2P"
3803,13,0.220338983,2.6,2014-03-05T13:36:21Z,2014-05-02T17:45:46Z,59,54,5,0.084745763,5,6,1,12,{'LD3': 1},1,5,{'LD3': 1},Build system
3810,9,0.044334975,4.5,2014-03-06T22:40:52Z,2014-09-25T10:21:59Z,203,201,2,0.009852217,2,5,4,5,"{'LD1': 3, 'LD4': 1}",3,2,"{'LD1': 2, 'LD4': 1}",Refactoring
3814,1,0.090909091,1,2014-03-07T15:32:01Z,2014-03-18T08:24:13Z,11,10,1,0.090909091,1,1,0,1,{},0,1,{},Refactoring
3816,75,0.0501002,3.409090909,2014-03-07T17:24:59Z,2018-04-11T19:18:23Z,1497,1475,22,0.014696059,12,24,22,53,"{'LD4': 11, 'LD3': 6, 'LD1': 3, 'LD6': 1, 'LD5': 1}",13,11,"{'LD4': 9, 'LD3': 5, 'LD1': 2, 'LD6': 1, 'LD5': 1}","Brainstorming,Wallet"
3825,3,0.333333333,1.5,2014-03-08T11:56:05Z,2014-03-16T13:33:58Z,9,7,2,0.222222222,2,3,2,1,"{'LD3': 1, 'LD4': 1}",2,1,"{'LD3': 1, 'LD4': 1}",
3826,2,0.166666667,2,2014-03-08T12:00:27Z,2014-03-19T16:54:40Z,12,11,1,0.083333333,2,2,2,0,"{'LD1': 1, 'LD3': 1}",2,0,"{'LD1': 1, 'LD3': 1}",
3831,1,1,1,2014-03-09T17:56:14Z,2014-03-09T22:18:31Z,1,0,1,1,0,1,1,0,{'LD5': 1},1,0,{'LD5': 1},
3840,5,0.555555556,2.5,2014-03-10T20:53:35Z,2014-03-19T10:46:36Z,9,7,2,0.222222222,2,2,4,1,"{'LD3': 2, 'LD6': 1, 'LD1': 1}",2,0,"{'LD3': 1, 'LD6': 1, 'LD1': 1}",
3848,14,1.75,14,2014-03-11T18:07:08Z,2014-03-18T22:24:40Z,8,7,1,0.125,1,11,8,6,{'LD3': 8},8,3,{'LD3': 8},
3851,2,1,2,2014-03-11T23:45:26Z,2014-03-13T06:40:17Z,2,1,1,0.5,1,1,1,1,{'LD1': 1},1,0,{'LD1': 1},
3853,9,0.00477707,4.5,2014-03-12T09:59:23Z,2019-05-09T05:42:54Z,1884,1882,2,0.001061571,1,4,5,4,"{'LD4': 3, 'LD6': 1, 'LD1': 1}",3,1,"{'LD4': 2, 'LD6': 1, 'LD1': 1}","Brainstorming,P2P"
3854,2,0.025974026,1,2014-03-12T15:35:36Z,2014-05-28T05:19:42Z,77,75,2,0.025974026,2,2,1,1,{'LD5': 1},1,1,{'LD5': 1},GUI
3856,1,0.5,1,2014-03-12T20:40:48Z,2014-03-13T21:24:18Z,2,1,1,0.5,1,1,0,1,{},0,1,{},
3858,5,0.025380711,5,2014-03-12T23:03:34Z,2014-09-25T10:25:25Z,197,196,1,0.005076142,1,2,2,3,"{'LD3': 1, 'LD4': 1}",1,1,"{'LD3': 1, 'LD4': 1}","Bug,Wallet"
3859,2,2,2,2014-03-12T23:24:47Z,2014-03-13T21:06:18Z,1,0,1,1,0,1,1,1,{'LD4': 1},1,0,{'LD4': 1},
3862,80,26.66666667,26.66666667,2014-03-13T16:41:52Z,2014-03-16T02:32:17Z,3,0,3,1,0,36,18,62,"{'LD4': 4, 'LD3': 10, 'LD1': 3, 'LD6': 1}",14,22,"{'LD4': 4, 'LD3': 9, 'LD1': 3, 'LD6': 1}",Refactoring
3866,1,1,1,2014-03-14T03:30:03Z,2014-03-14T03:53:32Z,1,0,1,1,0,1,1,0,{'LD3': 1},1,0,{'LD3': 1},
3869,1,0.006802721,1,2014-03-14T06:31:41Z,2014-08-07T19:16:08Z,147,146,1,0.006802721,1,1,0,1,{},0,1,{},"Bug,GUI"
3872,1,0.058823529,1,2014-03-14T14:30:11Z,2014-03-31T00:59:18Z,17,16,1,0.058823529,1,1,1,0,{'LD5': 1},1,0,{'LD5': 1},Refactoring
3882,8,0.007042254,2.666666667,2014-03-16T12:24:07Z,2017-04-25T11:51:05Z,1136,1133,3,0.002640845,2,4,2,6,{'LD3': 2},2,2,{'LD3': 2},Wallet
3886,2,0.010362694,2,2014-03-16T21:38:53Z,2014-09-25T10:26:36Z,193,192,1,0.005181347,1,2,1,1,{'LD1': 1},1,1,{'LD1': 1},GUI
3887,2,0.017391304,2,2014-03-16T21:54:35Z,2014-07-09T16:49:30Z,115,114,1,0.008695652,2,2,1,1,{'LD1': 1},1,1,{'LD1': 1},"GUI,Refactoring"
3896,2,0.006711409,1,2014-03-19T00:13:36Z,2015-01-10T09:28:42Z,298,296,2,0.006711409,2,2,1,1,{'LD5': 1},1,1,{'LD5': 1},GUI
3898,2,0.003401361,1,2014-03-19T05:43:42Z,2015-10-27T11:05:25Z,588,586,2,0.003401361,2,2,1,1,{'LD3': 1},1,1,{'LD3': 1},"Build system,Refactoring"
3900,2,0.001355014,1,2014-03-19T14:36:36Z,2018-04-02T21:05:09Z,1476,1474,2,0.001355014,2,2,1,1,{'LD4': 1},1,1,{'LD4': 1},GUI
3902,6,0.012121212,1.2,2014-03-19T16:52:47Z,2015-07-27T14:28:33Z,495,490,5,0.01010101,4,4,3,3,"{'LD3': 2, 'LD1': 1}",3,1,"{'LD3': 2, 'LD1': 1}",Refactoring
3903,5,0.098039216,1.666666667,2014-03-19T17:48:49Z,2014-05-09T08:14:16Z,51,48,3,0.058823529,2,3,1,4,{'LD3': 1},1,2,{'LD3': 1},"Bug,Wallet"
3905,7,1,3.5,2014-03-19T19:22:30Z,2014-03-26T09:42:58Z,7,5,2,0.285714286,2,2,3,4,"{'LD3': 1, 'LD4': 2}",2,0,"{'LD3': 1, 'LD4': 2}","Bug,GUI"
3908,1,1,1,2014-03-19T21:30:03Z,2014-03-19T22:28:04Z,1,0,1,1,0,1,1,0,{'LD2': 1},1,0,{'LD2': 1},
3911,3,0.007058824,3,2014-03-20T04:19:31Z,2015-05-18T08:40:11Z,425,424,1,0.002352941,1,1,0,3,{},0,1,{},GUI
3913,3,0.015228426,1,2014-03-20T04:40:00Z,2014-10-02T19:27:05Z,197,194,3,0.015228426,2,3,1,2,{'LD4': 1},1,2,{'LD4': 1},"Bug,GUI"
3915,1,0.001430615,1,2014-03-20T16:01:52Z,2016-02-16T16:30:30Z,699,698,1,0.001430615,1,1,0,1,{},0,1,{},"Feature,P2P"
3918,9,0.264705882,9,2014-03-20T20:55:31Z,2014-04-23T12:59:46Z,34,33,1,0.029411765,1,6,2,7,"{'LD4': 1, 'LD3': 1}",2,4,"{'LD4': 1, 'LD3': 1}",
3919,2,0.007042254,1,2014-03-21T01:02:54Z,2014-12-29T08:59:26Z,284,282,2,0.007042254,1,2,1,1,{'LD5': 1},1,1,{'LD5': 1},"GUI,macOS"
3921,1,0.00094697,1,2014-03-21T07:28:51Z,2017-02-08T14:00:06Z,1056,1055,1,0.00094697,2,1,0,1,{},0,1,{},"Build system,Wallet"
3925,1,0.00591716,1,2014-03-21T12:06:31Z,2014-09-05T12:44:25Z,169,168,1,0.00591716,1,1,0,1,{},0,1,{},GUI
3930,2,2,2,2014-03-21T17:04:24Z,2014-03-22T09:01:13Z,1,0,1,1,0,2,0,2,{},0,2,{},Docs
3940,3,1.5,3,2014-03-22T18:24:50Z,2014-03-23T21:30:03Z,2,1,1,0.5,1,3,1,2,{'LD5': 1},1,2,{'LD5': 1},
3943,1,0.001669449,1,2014-03-23T05:43:37Z,2015-11-11T11:35:45Z,599,598,1,0.001669449,2,1,0,1,{},0,1,{},"Bug,Build system,Wallet"
3945,11,0.081481481,1.833333333,2014-03-23T21:39:13Z,2014-08-05T01:44:15Z,135,129,6,0.044444444,6,3,2,9,"{'LD4': 1, 'LD6': 1}",2,1,"{'LD4': 1, 'LD6': 1}",Build system
3948,4,0.571428571,4,2014-03-24T13:09:22Z,2014-03-31T06:49:22Z,7,6,1,0.142857143,1,3,2,2,"{'LD3': 1, 'LD1': 1}",2,1,"{'LD3': 1, 'LD1': 1}",
3949,1,0.00096432,1,2014-03-24T13:30:30Z,2017-01-23T17:27:51Z,1037,1036,1,0.00096432,1,1,0,1,{},0,1,{},
3952,3,3,3,2014-03-24T23:30:52Z,2014-03-25T06:43:54Z,1,0,1,1,0,2,0,3,{},0,2,{},
3953,1,1,1,2014-03-25T02:37:59Z,2014-03-25T06:36:52Z,1,0,1,1,0,1,1,0,{'LD3': 1},1,0,{'LD3': 1},
3954,1,0.142857143,1,2014-03-25T03:08:48Z,2014-03-31T06:10:47Z,7,6,1,0.142857143,1,1,1,0,{'LD1': 1},1,0,{'LD1': 1},
3955,5,0.063291139,1.666666667,2014-03-25T03:16:39Z,2014-06-11T06:26:06Z,79,76,3,0.037974684,3,3,2,3,"{'LD1': 1, 'LD4': 1}",1,2,"{'LD1': 1, 'LD4': 1}",Build system
3957,2,0.028985507,1,2014-03-25T09:39:34Z,2014-06-01T15:48:45Z,69,67,2,0.028985507,3,2,2,0,"{'LD3': 1, 'LD5': 1}",2,0,"{'LD3': 1, 'LD5': 1}",Bug
3963,6,0.023809524,3,2014-03-26T06:43:30Z,2014-12-02T08:15:36Z,252,250,2,0.007936508,3,4,1,5,{'LD5': 1},1,3,{'LD5': 1},
3966,2,0.012048193,1,2014-03-27T11:00:16Z,2014-09-08T11:51:23Z,166,164,2,0.012048193,3,2,0,2,{},0,2,{},Bug
3967,1,1,1,2014-03-27T18:00:56Z,2014-03-27T20:10:11Z,1,0,1,1,0,1,0,1,{},0,1,{},
3968,9,0.015151515,1.125,2014-03-27T22:16:18Z,2015-11-11T11:33:46Z,594,586,8,0.013468013,7,6,7,2,"{'LD4': 5, 'LD1': 1, 'LD2': 1}",5,1,"{'LD4': 3, 'LD1': 1, 'LD2': 1}","Bug,RPC/REST/ZMQ"
3970,5,0.027472527,1.25,2014-03-28T07:29:16Z,2014-09-25T10:28:19Z,182,178,4,0.021978022,4,4,2,3,{'LD3': 2},1,3,{'LD3': 1},"GUI,Refactoring"
3971,1,0.090909091,1,2014-03-28T11:00:50Z,2014-04-07T15:50:05Z,11,10,1,0.090909091,1,1,0,1,{},0,1,{},"Build system,Refactoring,Wallet"
3974,2,0.2,1,2014-03-28T17:18:31Z,2014-04-07T05:32:55Z,10,8,2,0.2,1,2,2,0,"{'LD4': 1, 'LD1': 1}",2,0,"{'LD4': 1, 'LD1': 1}","GUI,Wallet"
3978,3,0.75,3,2014-03-29T04:18:08Z,2014-04-01T13:48:56Z,4,3,1,0.25,1,1,1,2,{'LD4': 1},1,0,{'LD4': 1},
3979,2,0.008264463,1,2014-03-29T04:20:11Z,2014-11-25T04:33:23Z,242,240,2,0.008264463,2,2,0,2,{},0,2,{},Build system
3981,4,2,2,2014-03-30T19:19:54Z,2014-04-01T16:06:37Z,2,0,2,1,0,3,0,4,{},0,3,{},
3989,4,0.571428571,1.333333333,2014-04-01T04:16:21Z,2014-04-07T07:33:27Z,7,4,3,0.428571429,2,2,0,4,{},0,2,{},Build system
3992,1,0.025641026,1,2014-04-01T08:44:30Z,2014-05-09T10:32:09Z,39,38,1,0.025641026,2,1,0,1,{},0,1,{},
3993,1,0.008264463,1,2014-04-02T02:11:29Z,2014-07-31T08:02:26Z,121,120,1,0.008264463,1,1,0,1,{},0,1,{},
3997,7,0.35,1.4,2014-04-02T20:16:29Z,2014-04-22T11:35:47Z,20,15,5,0.25,3,1,4,3,"{'LD3': 3, 'LD1': 1}",1,0,"{'LD3': 1, 'LD1': 1}",Bug
4000,2,2,2,2014-04-03T17:03:52Z,2014-04-04T07:41:08Z,1,0,1,1,0,2,1,1,{'LD3': 1},1,1,{'LD3': 1},
4003,1,0.025641026,1,2014-04-05T04:03:17Z,2014-05-13T06:52:35Z,39,38,1,0.025641026,1,1,1,0,{'LD4': 1},1,0,{'LD4': 1},Bug
4006,4,0.033898305,2,2014-04-05T12:39:16Z,2014-07-31T13:28:04Z,118,116,2,0.016949153,2,3,1,3,{'LD4': 1},1,2,{'LD4': 1},"Docs,GUI"
4007,7,0.003164557,1.75,2014-04-05T15:03:35Z,2020-04-25T14:02:34Z,2212,2208,4,0.001808318,3,7,1,6,{'LD1': 1},1,6,{'LD1': 1},"Feature,UTXO Db and Indexes"
4012,2,2,2,2014-04-06T15:33:30Z,2014-04-07T05:42:23Z,1,0,1,1,0,2,2,0,"{'LD4': 1, 'LD1': 1}",2,0,"{'LD4': 1, 'LD1': 1}",
4013,2,1,2,2014-04-06T17:00:13Z,2014-04-08T06:41:48Z,2,1,1,0.5,1,2,0,2,{},0,2,{},Bug
4017,1,0.016666667,1,2014-04-07T07:42:27Z,2014-06-06T06:35:18Z,60,59,1,0.016666667,1,1,1,0,{'LD5': 1},1,0,{'LD5': 1},Build system
4021,1,0.04,1,2014-04-08T03:14:12Z,2014-05-02T07:26:08Z,25,24,1,0.04,1,1,1,0,{'LD6': 1},1,0,{'LD6': 1},
4026,4,0.166666667,4,2014-04-08T21:34:59Z,2014-05-02T07:18:02Z,24,23,1,0.041666667,1,3,1,3,{'LD4': 1},1,2,{'LD4': 1},
4027,1,1,1,2014-04-08T22:14:15Z,2014-04-08T22:24:32Z,1,0,1,1,0,1,0,1,{},0,1,{},
4029,1,0.045454545,1,2014-04-09T10:36:56Z,2014-05-01T06:21:10Z,22,21,1,0.045454545,2,1,0,1,{},0,1,{},"Docs,macOS"
4034,2,0.001398601,1,2014-04-09T14:04:51Z,2018-03-09T03:32:44Z,1430,1428,2,0.001398601,2,2,0,2,{},0,2,{},"Bug,Resource usage"
4036,6,0.315789474,6,2014-04-09T15:40:10Z,2014-04-27T16:22:21Z,19,18,1,0.052631579,1,4,2,4,"{'LD5': 1, 'LD1': 1}",1,3,"{'LD5': 1, 'LD1': 1}",GUI
4046,1,0.002487562,1,2014-04-12T00:19:23Z,2015-05-18T08:39:23Z,402,401,1,0.002487562,1,1,1,0,{'LD1': 1},1,0,{'LD1': 1},"GUI,Refactoring"
4051,1,0.001779359,1,2014-04-13T12:20:34Z,2015-10-27T11:02:19Z,562,561,1,0.001779359,1,1,0,1,{},0,1,{},Bug
4053,2,0.083333333,1,2014-04-13T16:52:43Z,2014-05-06T20:09:46Z,24,22,2,0.083333333,2,2,2,0,"{'LD4': 1, 'LD5': 1}",2,0,"{'LD4': 1, 'LD5': 1}","Build system,macOS"
4054,2,2,2,2014-04-14T11:43:49Z,2014-04-14T12:22:22Z,1,0,1,1,0,1,0,2,{},0,1,{},
4057,4,0.002224694,1,2014-04-15T11:33:18Z,2019-03-18T10:17:33Z,1798,1794,4,0.002224694,4,3,1,3,{'LD5': 1},1,2,{'LD5': 1},"Feature,P2P"
4059,3,0.013392857,3,2014-04-15T16:44:32Z,2014-11-25T13:44:43Z,224,223,1,0.004464286,1,2,0,3,{},0,2,{},Bug
4061,1,0.5,1,2014-04-16T07:26:37Z,2014-04-17T07:28:06Z,2,1,1,0.5,1,1,0,1,{},0,1,{},Windows
4062,3,3,3,2014-04-16T09:50:41Z,2014-04-16T15:43:56Z,1,0,1,1,0,1,0,3,{},0,1,{},
4064,3,0.005226481,1,2014-04-16T13:06:34Z,2015-11-11T11:32:18Z,574,571,3,0.005226481,3,3,2,1,"{'LD4': 1, 'LD3': 1}",2,1,"{'LD4': 1, 'LD3': 1}","Bug,UTXO Db and Indexes"
4065,4,0.148148148,2,2014-04-16T18:23:24Z,2014-05-13T06:50:09Z,27,25,2,0.074074074,2,2,2,2,{'LD3': 2},2,0,{'LD3': 2},GUI
4066,6,0.01511335,6,2014-04-16T21:45:16Z,2015-05-18T08:35:05Z,397,396,1,0.002518892,1,2,3,3,"{'LD4': 2, 'LD1': 1}",2,0,"{'LD4': 1, 'LD1': 1}",Bug
4069,82,0.152985075,5.466666667,2014-04-19T04:00:43Z,2015-10-06T15:54:24Z,536,521,15,0.027985075,6,20,22,60,"{'LD3': 7, 'LD1': 6, 'LD4': 9}",11,9,"{'LD3': 4, 'LD1': 5, 'LD4': 7}",Windows
4070,2,0.005063291,1,2014-04-19T08:33:15Z,2015-05-18T08:38:56Z,395,393,2,0.005063291,3,2,1,1,{'LD1': 1},1,1,{'LD1': 1},"Bug,P2P"
4071,1,0.002212389,1,2014-04-19T17:06:56Z,2015-07-15T13:13:53Z,452,451,1,0.002212389,2,1,0,1,{},0,1,{},Tests
4073,2,2,2,2014-04-19T17:09:04Z,2014-04-20T15:58:00Z,1,0,1,1,0,2,0,2,{},0,2,{},
4079,10,0.181818182,5,2014-04-22T06:41:15Z,2014-06-15T14:57:23Z,55,53,2,0.036363636,2,3,3,7,"{'LD1': 1, 'LD3': 2}",2,1,"{'LD1': 1, 'LD3': 2}",Feature
4082,2,0.001819836,1,2014-04-22T17:29:45Z,2017-04-25T11:51:47Z,1099,1097,2,0.001819836,2,2,1,1,{'LD3': 1},1,1,{'LD3': 1},"TX fees and policy,Wallet"
4083,4,4,4,2014-04-22T18:26:11Z,2014-04-23T15:06:40Z,1,0,1,1,0,2,0,4,{},0,2,{},
4084,2,2,2,2014-04-22T19:59:30Z,2014-04-23T15:06:40Z,1,0,1,1,0,1,0,2,{},0,1,{},
4086,2,2,2,2014-04-24T03:04:03Z,2014-04-24T07:52:55Z,1,0,1,1,0,1,1,1,{'LD1': 1},1,0,{'LD1': 1},
4091,5,0.004456328,2.5,2014-04-24T17:02:58Z,2017-05-20T10:07:12Z,1122,1120,2,0.001782531,3,2,2,3,"{'LD4': 1, 'LD2': 1}",2,0,"{'LD4': 1, 'LD2': 1}","Bug,P2P"
4093,5,1.25,2.5,2014-04-25T15:48:12Z,2014-04-29T13:28:34Z,4,2,2,0.5,1,1,2,3,"{'LD1': 1, 'LD4': 1}",1,0,"{'LD1': 1, 'LD4': 1}","Refactoring,Wallet"
4095,1,0.001267427,1,2014-04-26T05:02:00Z,2016-06-22T11:01:24Z,789,788,1,0.001267427,1,1,0,1,{},0,1,{},"GUI,Windows"
4097,2,0.020833333,1,2014-04-26T19:10:08Z,2014-07-31T08:10:24Z,96,94,2,0.020833333,2,2,1,1,{'LD3': 1},1,1,{'LD3': 1},
4099,1,1,1,2014-04-27T20:21:13Z,2014-04-28T01:51:24Z,1,0,1,1,0,1,0,1,{},0,1,{},
4103,1,1,1,2014-04-28T18:19:45Z,2014-04-29T05:52:32Z,1,0,1,1,0,1,1,0,{'LD5': 1},1,0,{'LD5': 1},
4108,1,1,1,2014-04-30T05:31:01Z,2014-04-30T06:47:44Z,1,0,1,1,0,1,0,1,{},0,1,{},
4112,2,0.001592357,1,2014-04-30T17:49:11Z,2017-10-07T14:45:42Z,1256,1254,2,0.001592357,3,2,0,2,{},0,2,{},"Bug,GUI"
4118,3,0.083333333,1,2014-05-02T07:57:38Z,2014-06-06T16:39:47Z,36,33,3,0.083333333,2,3,2,1,"{'LD4': 1, 'LD5': 1}",2,1,"{'LD4': 1, 'LD5': 1}",Build system
4124,14,0.025830258,2,2014-05-04T10:22:57Z,2015-10-27T11:03:32Z,542,535,7,0.012915129,7,6,4,10,"{'LD3': 1, 'LD4': 2, 'LD1': 1}",3,3,"{'LD3': 1, 'LD4': 2, 'LD1': 1}",Feature
4125,6,0.015831135,2,2014-05-05T01:21:51Z,2015-05-18T08:37:19Z,379,376,3,0.007915567,2,4,2,4,"{'LD2': 1, 'LD3': 1}",2,2,"{'LD2': 1, 'LD3': 1}","Bug,UTXO Db and Indexes"
4126,1,1,1,2014-05-05T01:57:48Z,2014-05-05T06:42:41Z,1,0,1,1,0,1,1,0,{'LD1': 1},1,0,{'LD1': 1},
4128,5,5,5,2014-05-05T12:56:28Z,2014-05-05T18:14:57Z,1,0,1,1,0,4,1,4,{'LD6': 1},1,3,{'LD6': 1},
4133,4,0.06779661,4,2014-05-06T08:03:00Z,2014-07-04T04:27:29Z,59,58,1,0.016949153,2,3,0,4,{},0,3,{},GUI
4137,5,0.833333333,1.666666667,2014-05-06T13:18:54Z,2014-05-12T09:30:15Z,6,3,3,0.5,2,3,3,2,"{'LD4': 2, 'LD3': 1}",3,0,"{'LD4': 2, 'LD3': 1}","Refactoring,UTXO Db and Indexes"
4139,2,2,2,2014-05-06T18:52:03Z,2014-05-07T13:16:20Z,1,0,1,1,0,1,0,2,{},0,1,{},Bug
4140,4,0.166666667,2,2014-05-06T21:49:03Z,2014-05-29T22:13:28Z,24,22,2,0.083333333,2,3,1,3,{'LD5': 1},1,2,{'LD5': 1},"Bug,GUI"
4146,1,0.008849558,1,2014-05-07T18:06:20Z,2014-08-28T03:46:03Z,113,112,1,0.008849558,2,1,0,1,{},0,1,{},TX fees and policy
4147,31,0.047692308,3.1,2014-05-07T20:14:45Z,2016-02-16T17:44:29Z,650,640,10,0.015384615,6,7,8,23,"{'LD4': 5, 'LD1': 1, 'LD2': 1, 'LD3': 1}",3,4,"{'LD4': 2, 'LD1': 1, 'LD2': 1, 'LD3': 1}",Bug
4153,3,3,3,2014-05-08T17:54:25Z,2014-05-08T18:42:14Z,1,0,1,1,0,3,1,2,{'LD4': 1},1,2,{'LD4': 1},
4154,2,2,2,2014-05-09T01:51:39Z,2014-05-09T09:40:38Z,1,0,1,1,0,2,0,2,{},0,2,{},
4157,4,0.001834862,1,2014-05-09T08:20:45Z,2020-04-27T00:02:43Z,2180,2176,4,0.001834862,4,3,1,3,{'LD4': 1},1,2,{'LD4': 1},"Brainstorming,RPC/REST/ZMQ"
4162,7,0.00464499,1.4,2014-05-09T17:37:56Z,2018-06-24T00:11:21Z,1507,1502,5,0.00331785,3,5,2,5,"{'LD1': 1, 'LD3': 1}",2,3,"{'LD1': 1, 'LD3': 1}","Feature,RPC/REST/ZMQ"
4168,1,1,1,2014-05-10T10:01:47Z,2014-05-10T10:42:47Z,1,0,1,1,0,1,1,0,{'LD2': 1},1,0,{'LD2': 1},Brainstorming
4171,7,3.5,7,2014-05-11T03:13:11Z,2014-05-12T06:57:21Z,2,1,1,0.5,1,4,4,3,"{'LD1': 2, 'LD3': 1, 'LD2': 1}",3,1,"{'LD1': 2, 'LD3': 1, 'LD2': 1}",
4172,1,1,1,2014-05-11T04:50:27Z,2014-05-11T16:29:19Z,1,0,1,1,0,1,1,0,{'LD4': 1},1,0,{'LD4': 1},
4178,4,0.05,2,2014-05-12T17:48:28Z,2014-07-31T08:01:06Z,80,78,2,0.025,2,3,3,1,"{'LD4': 2, 'LD1': 1}",3,0,"{'LD4': 2, 'LD1': 1}",
4192,1,0.333333333,1,2014-05-17T04:07:03Z,2014-05-19T19:21:34Z,3,2,1,0.333333333,1,1,0,1,{},0,1,{},
4196,2,2,2,2014-05-19T15:56:33Z,2014-05-19T20:47:26Z,1,0,1,1,0,2,1,1,{'LD4': 1},1,1,{'LD4': 1},
4209,5,0.035460993,1.25,2014-05-21T19:15:55Z,2014-10-09T10:36:33Z,141,137,4,0.028368794,2,3,2,3,"{'LD4': 1, 'LD5': 1}",1,2,"{'LD4': 1, 'LD5': 1}",Wallet
4210,1,1,1,2014-05-22T08:05:04Z,2014-05-22T08:14:44Z,1,0,1,1,0,1,0,1,{},0,1,{},
4216,1,1,1,2014-05-23T00:25:20Z,2014-05-23T00:32:26Z,1,0,1,1,0,1,0,1,{},0,1,{},
4219,2,0.003184713,1,2014-05-23T14:13:40Z,2016-02-09T16:23:03Z,628,626,2,0.003184713,2,2,2,0,"{'LD3': 1, 'LD5': 1}",2,0,"{'LD3': 1, 'LD5': 1}",Refactoring
4221,5,0.25,5,2014-05-23T15:53:05Z,2014-06-12T12:18:23Z,20,19,1,0.05,1,4,1,4,{'LD3': 1},1,3,{'LD3': 1},Refactoring
4224,1,0.027777778,1,2014-05-23T17:41:51Z,2014-06-28T13:09:22Z,36,35,1,0.027777778,1,1,0,1,{},0,1,{},Bug
4235,2,0.001813237,1,2014-05-27T01:51:05Z,2017-06-02T02:17:14Z,1103,1101,2,0.001813237,3,2,1,1,{'LD3': 1},1,1,{'LD3': 1},"Bug,RPC/REST/ZMQ"
4237,3,0.004754358,1,2014-05-27T10:47:45Z,2016-02-16T13:20:37Z,631,628,3,0.004754358,3,3,2,1,"{'LD1': 1, 'LD3': 1}",2,1,"{'LD1': 1, 'LD3': 1}",Refactoring
4242,1,0.001589825,1,2014-05-29T00:59:57Z,2016-02-16T13:17:55Z,629,628,1,0.001589825,1,1,1,0,{'LD1': 1},1,0,{'LD1': 1},RPC/REST/ZMQ
4244,1,0.003759398,1,2014-05-29T03:06:45Z,2015-02-18T22:00:46Z,266,265,1,0.003759398,1,1,1,0,{'LD2': 1},1,0,{'LD2': 1},"RPC/REST/ZMQ,Wallet"
4246,2,0.090909091,2,2014-05-29T08:57:04Z,2014-06-19T12:38:57Z,22,21,1,0.045454545,1,1,0,2,{},0,1,{},Bug
4248,2,0.003846154,2,2014-05-29T12:24:08Z,2015-10-31T11:29:08Z,520,519,1,0.001923077,1,1,1,1,{'LD4': 1},1,0,{'LD4': 1},GUI
4253,5,0.833333333,2.5,2014-05-29T20:23:47Z,2014-06-04T17:30:55Z,6,4,2,0.333333333,2,4,1,4,{'LD4': 1},1,3,{'LD4': 1},
4263,3,0.007832898,1,2014-05-31T07:32:50Z,2015-06-17T14:25:04Z,383,380,3,0.007832898,3,3,2,1,"{'LD1': 1, 'LD4': 1}",2,1,"{'LD1': 1, 'LD4': 1}","Bug,UTXO Db and Indexes"
4265,1,0.333333333,1,2014-05-31T16:40:38Z,2014-06-03T09:54:00Z,3,2,1,0.333333333,2,1,1,0,{'LD3': 1},1,0,{'LD3': 1},Build system
4266,2,0.003194888,1,2014-05-31T23:53:41Z,2016-02-16T13:14:37Z,626,624,2,0.003194888,2,2,1,1,{'LD3': 1},1,1,{'LD3': 1},"Bug,P2P"
4269,1,0.016666667,1,2014-06-01T20:17:02Z,2014-07-31T08:22:48Z,60,59,1,0.016666667,1,1,1,0,{'LD3': 1},1,0,{'LD3': 1},Docs
4272,1,0.001937984,1,2014-06-02T15:24:48Z,2015-10-31T11:29:02Z,516,515,1,0.001937984,2,1,0,1,{},0,1,{},"GUI,Wallet"
4274,1,0.111111111,1,2014-06-02T20:46:14Z,2014-06-11T05:05:28Z,9,8,1,0.111111111,1,1,1,0,{'LD3': 1},1,0,{'LD3': 1},Build system
4276,1,1,1,2014-06-02T21:59:40Z,2014-06-02T23:04:13Z,1,0,1,1,0,1,0,1,{},0,1,{},
4296,3,0.053571429,3,2014-06-06T05:59:26Z,2014-07-31T07:57:32Z,56,55,1,0.017857143,1,1,1,2,{'LD4': 1},1,0,{'LD4': 1},
4313,3,0.6,3,2014-06-09T18:26:36Z,2014-06-14T09:32:16Z,5,4,1,0.2,1,1,1,2,{'LD4': 1},1,0,{'LD4': 1},Wallet
4315,1,0.166666667,1,2014-06-10T03:09:02Z,2014-06-15T21:17:26Z,6,5,1,0.166666667,1,1,1,0,{'LD2': 1},1,0,{'LD2': 1},
4320,1,1,1,2014-06-10T17:29:12Z,2014-06-10T17:49:51Z,1,0,1,1,0,1,1,0,{'LD3': 1},1,0,{'LD3': 1},
4338,6,0.009787928,3,2014-06-14T00:33:03Z,2016-02-16T12:36:11Z,613,611,2,0.003262643,3,4,0,6,{},0,4,{},Brainstorming
4341,7,0.014767932,1.4,2014-06-15T15:57:30Z,2015-10-01T20:44:02Z,474,469,5,0.010548523,4,5,1,6,{'LD4': 1},1,4,{'LD4': 1},RPC/REST/ZMQ
4343,9,0.409090909,4.5,2014-06-15T23:26:33Z,2014-07-07T08:30:15Z,22,20,2,0.090909091,2,2,3,6,"{'LD3': 2, 'LD6': 1}",2,0,"{'LD3': 2, 'LD6': 1}",RPC/REST/ZMQ
4344,4,0.016129032,1.333333333,2014-06-16T00:25:08Z,2015-02-18T16:25:41Z,248,245,3,0.012096774,3,3,1,3,{'LD5': 1},1,2,{'LD5': 1},"Brainstorming,Validation"
4345,6,3,3,2014-06-16T06:07:38Z,2014-06-17T15:42:30Z,2,0,2,1,0,2,1,5,{'LD5': 1},1,1,{'LD5': 1},"Bug,UTXO Db and Indexes"
4352,2,0.666666667,2,2014-06-16T20:49:05Z,2014-06-19T07:34:53Z,3,2,1,0.333333333,1,2,0,2,{},0,2,{},RPC/REST/ZMQ
4353,9,0.052325581,3,2014-06-16T21:16:02Z,2014-12-05T13:19:41Z,172,169,3,0.01744186,3,5,4,5,"{'LD3': 2, 'LD4': 1, 'LD1': 1}",3,2,"{'LD3': 2, 'LD4': 1, 'LD1': 1}",P2P
4355,3,0.1875,1.5,2014-06-17T05:01:47Z,2014-07-02T07:48:22Z,16,14,2,0.125,2,2,2,1,"{'LD4': 1, 'LD3': 1}",2,0,"{'LD4': 1, 'LD3': 1}",Wallet
4356,9,0.026785714,2.25,2014-06-17T06:43:49Z,2015-05-18T08:34:18Z,336,332,4,0.011904762,3,5,2,7,"{'LD3': 1, 'LD1': 1}",2,3,"{'LD3': 1, 'LD1': 1}",P2P
4359,2,0.01242236,2,2014-06-17T08:24:41Z,2014-11-25T04:26:05Z,161,160,1,0.00621118,1,2,2,0,"{'LD4': 1, 'LD1': 1}",2,0,"{'LD4': 1, 'LD1': 1}",Build system
4360,1,0.037037037,1,2014-06-17T14:36:44Z,2014-07-14T09:33:39Z,27,26,1,0.037037037,1,1,0,1,{},0,1,{},
4362,9,0.026865672,1.8,2014-06-18T08:19:53Z,2015-05-18T08:30:20Z,335,330,5,0.014925373,3,3,3,6,"{'LD4': 1, 'LD3': 2}",1,2,"{'LD4': 1, 'LD3': 1}",UTXO Db and Indexes
4364,1,0.023255814,1,2014-06-18T10:34:30Z,2014-07-31T07:56:29Z,43,42,1,0.023255814,2,1,1,0,{'LD1': 1},1,0,{'LD1': 1},Data corruption
4367,2,2,2,2014-06-19T03:37:52Z,2014-06-19T08:37:58Z,1,0,1,1,0,1,1,1,{'LD1': 1},1,0,{'LD1': 1},
4370,2,2,2,2014-06-19T14:37:28Z,2014-06-20T06:45:27Z,1,0,1,1,0,1,1,1,{'LD2': 1},1,0,{'LD2': 1},
4372,4,0.020618557,1,2014-06-20T13:17:01Z,2014-12-30T14:03:40Z,194,190,4,0.020618557,3,3,3,1,"{'LD4': 2, 'LD3': 1}",2,1,"{'LD4': 1, 'LD3': 1}",GUI
4375,2,0.048780488,2,2014-06-21T05:20:38Z,2014-07-31T07:56:13Z,41,40,1,0.024390244,1,2,1,1,{'LD1': 1},1,1,{'LD1': 1},
4376,2,0.285714286,1,2014-06-21T07:52:44Z,2014-06-28T06:58:22Z,7,5,2,0.285714286,2,1,2,0,{'LD1': 2},1,0,{'LD1': 1},Docs
4382,1,0.001054852,1,2014-06-21T17:12:22Z,2017-01-23T17:41:36Z,948,947,1,0.001054852,1,1,0,1,{},0,1,{},"Brainstorming,P2P,Refactoring"
4384,1,1,1,2014-06-21T18:42:18Z,2014-06-21T18:48:01Z,1,0,1,1,0,1,1,0,{'LD4': 1},1,0,{'LD4': 1},
4387,1,0.00280112,1,2014-06-22T02:14:30Z,2015-06-13T12:36:18Z,357,356,1,0.00280112,2,1,0,1,{},0,1,{},P2P
4410,2,0.666666667,2,2014-06-25T02:11:51Z,2014-06-27T03:17:09Z,3,2,1,0.333333333,1,2,0,2,{},0,2,{},
4416,1,0.001663894,1,2014-06-26T06:01:44Z,2016-02-16T15:12:01Z,601,600,1,0.001663894,1,1,1,0,{'LD2': 1},1,0,{'LD2': 1},Brainstorming
4417,10,0.012626263,2.5,2014-06-26T14:37:30Z,2016-08-26T13:31:47Z,792,788,4,0.005050505,4,5,4,6,"{'LD4': 2, 'LD3': 2}",4,1,"{'LD4': 2, 'LD3': 2}",Resource usage
4419,2,0.0625,1,2014-06-26T18:25:11Z,2014-07-28T12:37:50Z,32,30,2,0.0625,3,2,1,1,{'LD3': 1},1,1,{'LD3': 1},Docs
4427,1,1,1,2014-06-27T11:59:54Z,2014-06-27T16:53:18Z,1,0,1,1,0,1,0,1,{},0,1,{},
4433,1,0.001062699,1,2014-06-28T04:14:57Z,2017-01-23T21:16:33Z,941,940,1,0.001062699,1,1,1,0,{'LD4': 1},1,0,{'LD4': 1},"Bug,Docs"
4439,4,0.133333333,4,2014-06-28T19:35:37Z,2014-07-28T13:59:11Z,30,29,1,0.033333333,1,4,1,3,{'LD3': 1},1,3,{'LD3': 1},Brainstorming
4445,2,0.068965517,2,2014-06-30T11:15:23Z,2014-07-28T11:59:00Z,29,28,1,0.034482759,1,1,0,2,{},0,1,{},"GUI,P2P"
4458,5,0.008710801,2.5,2014-07-02T17:38:20Z,2016-01-27T16:27:37Z,574,572,2,0.003484321,2,2,0,5,{},0,2,{},"Bug,RPC/REST/ZMQ"
4461,1,0.001101322,1,2014-07-03T17:08:39Z,2016-12-27T16:06:36Z,908,907,1,0.001101322,1,1,0,1,{},0,1,{},"Bug,P2P"
4469,3,0.020689655,1.5,2014-07-06T00:26:17Z,2014-11-27T12:54:58Z,145,143,2,0.013793103,1,1,2,1,"{'LD1': 1, 'LD5': 1}",1,0,"{'LD1': 1, 'LD5': 1}","Bug,UTXO Db and Indexes"
4473,2,2,2,2014-07-06T16:23:19Z,2014-07-07T10:50:39Z,1,0,1,1,0,1,0,2,{},0,1,{},Build system
4474,2,2,2,2014-07-06T17:02:09Z,2014-07-07T05:39:29Z,1,0,1,1,0,1,1,1,{'LD3': 1},1,0,{'LD3': 1},
4475,1,1,1,2014-07-07T02:26:23Z,2014-07-07T04:30:40Z,1,0,1,1,0,1,1,0,{'LD2': 1},1,0,{'LD2': 1},
4478,6,3,3,2014-07-07T12:07:22Z,2014-07-09T06:45:27Z,2,0,2,1,0,3,2,4,{'LD3': 2},1,2,{'LD3': 1},
4487,1,1,1,2014-07-08T16:27:24Z,2014-07-08T18:23:49Z,1,0,1,1,0,1,0,1,{},0,1,{},
4493,1,0.001075269,1,2014-07-09T11:02:03Z,2017-01-23T17:56:46Z,930,929,1,0.001075269,1,1,0,1,{},0,1,{},Bug
4502,1,0.003194888,1,2014-07-10T04:48:50Z,2015-05-18T08:33:48Z,313,312,1,0.003194888,1,1,1,0,{'LD3': 1},1,0,{'LD3': 1},
4509,2,0.001490313,1,2014-07-11T13:55:06Z,2018-03-14T12:11:04Z,1342,1340,2,0.001490313,2,2,0,2,{},0,2,{},"Bug,Wallet"
4512,2,0.117647059,2,2014-07-12T08:07:56Z,2014-07-28T11:55:34Z,17,16,1,0.058823529,1,2,0,2,{},0,2,{},
4517,1,0.013333333,1,2014-07-12T20:28:24Z,2014-09-25T10:49:44Z,75,74,1,0.013333333,1,1,0,1,{},0,1,{},
4538,2,0.003484321,1,2014-07-15T16:51:34Z,2016-02-09T16:19:53Z,574,572,2,0.003484321,1,2,1,1,{'LD2': 1},1,1,{'LD2': 1},P2P
4540,2,0.153846154,2,2014-07-15T21:48:53Z,2014-07-28T11:54:16Z,13,12,1,0.076923077,2,2,1,1,{'LD4': 1},1,1,{'LD4': 1},Wallet
4545,11,0.013664596,1.571428571,2014-07-16T17:16:10Z,2016-09-27T19:28:48Z,805,798,7,0.008695652,6,5,5,6,"{'LD4': 3, 'LD3': 2}",4,1,"{'LD4': 3, 'LD3': 2}","Brainstorming,Tests"
4548,3,1.5,1.5,2014-07-16T23:27:14Z,2014-07-18T07:28:56Z,2,0,2,1,0,2,0,3,{},0,2,{},
4550,29,0.037958115,4.833333333,2014-07-17T13:41:08Z,2016-08-19T10:11:07Z,764,758,6,0.007853403,1,8,10,19,"{'LD2': 1, 'LD3': 5, 'LD4': 3, 'LD1': 1}",6,2,"{'LD2': 1, 'LD3': 4, 'LD4': 2, 'LD1': 1}",TX fees and policy
4552,5,0.161290323,1.666666667,2014-07-17T23:26:05Z,2014-08-17T13:04:54Z,31,28,3,0.096774194,3,1,5,0,"{'LD4': 2, 'LD1': 2, 'LD3': 1}",1,0,"{'LD4': 1, 'LD1': 1, 'LD3': 1}","Docs,Linux/Unix"
4564,5,0.016556291,1.666666667,2014-07-20T20:17:02Z,2015-05-18T08:29:47Z,302,299,3,0.009933775,3,2,3,2,"{'LD4': 1, 'LD5': 2}",2,0,"{'LD4': 1, 'LD5': 1}","Privacy,Wallet"
4565,1,0.000475059,1,2014-07-21T00:47:29Z,2020-04-24T20:08:02Z,2105,2104,1,0.000475059,2,1,1,0,{'LD3': 1},1,0,{'LD3': 1},"Feature,P2P"
4572,2,2,2,2014-07-22T14:55:45Z,2014-07-22T16:26:52Z,1,0,1,1,0,2,0,2,{},0,2,{},
4574,5,0.076923077,2.5,2014-07-23T08:57:49Z,2014-09-25T10:33:25Z,65,63,2,0.030769231,1,2,3,2,"{'LD4': 1, 'LD1': 1, 'LD3': 1}",2,0,"{'LD4': 1, 'LD1': 1, 'LD3': 1}","Build system,Docs"
4580,1,0.090909091,1,2014-07-24T03:08:50Z,2014-08-03T15:09:02Z,11,10,1,0.090909091,1,1,1,0,{'LD3': 1},1,0,{'LD3': 1},"GUI,Wallet"
4583,9,1.8,3,2014-07-24T13:52:24Z,2014-07-29T06:06:22Z,5,2,3,0.6,1,4,5,4,"{'LD1': 2, 'LD4': 2, 'LD5': 1}",3,1,"{'LD1': 1, 'LD4': 2, 'LD5': 1}","GUI,Wallet"
4596,8,0.051612903,1.6,2014-07-28T03:45:31Z,2014-12-29T09:09:44Z,155,150,5,0.032258065,3,4,6,2,"{'LD3': 3, 'LD4': 2, 'LD5': 1}",4,0,"{'LD3': 3, 'LD4': 1, 'LD5': 1}","Build system,macOS"
4601,3,0.023076923,1.5,2014-07-29T11:33:41Z,2014-12-05T11:51:47Z,130,128,2,0.015384615,1,3,1,2,{'LD2': 1},1,2,{'LD2': 1},Refactoring
4604,3,0.375,1.5,2014-07-30T09:29:10Z,2014-08-07T08:50:53Z,8,6,2,0.25,1,2,0,3,{},0,2,{},"RPC/REST/ZMQ,Wallet"
4607,1,0.071428571,1,2014-07-30T22:26:14Z,2014-08-13T12:51:24Z,14,13,1,0.071428571,1,1,1,0,{'LD2': 1},1,0,{'LD2': 1},"Bug,TX fees and policy"
4609,1,0.000520021,1,2014-07-31T04:39:18Z,2019-11-04T15:40:50Z,1923,1922,1,0.000520021,2,1,1,0,{'LD4': 1},1,0,{'LD4': 1},P2P
4620,4,4,4,2014-08-02T14:39:19Z,2014-08-03T11:03:26Z,1,0,1,1,0,2,1,3,{'LD3': 1},1,1,{'LD3': 1},
4621,1,1,1,2014-08-02T16:34:58Z,2014-08-03T12:31:08Z,1,0,1,1,0,1,0,1,{},0,1,{},
4625,1,0.00625,1,2014-08-03T17:52:20Z,2015-01-10T10:01:34Z,160,159,1,0.00625,2,1,1,0,{'LD5': 1},1,0,{'LD5': 1},Tests
4628,5,5,5,2014-08-04T14:13:31Z,2014-08-05T14:06:41Z,1,0,1,1,0,1,3,2,{'LD4': 3},1,0,{'LD4': 1},
4630,1,1,1,2014-08-04T17:17:05Z,2014-08-05T13:21:32Z,1,0,1,1,0,1,1,0,{'LD3': 1},1,0,{'LD3': 1},
4634,8,2,4,2014-08-05T07:54:16Z,2014-08-08T09:28:31Z,4,2,2,0.5,1,3,0,8,{},0,3,{},
4639,1,0.000763359,1,2014-08-05T19:41:25Z,2018-03-07T19:35:49Z,1310,1309,1,0.000763359,2,1,1,0,{'LD4': 1},1,0,{'LD4': 1},"Bug,TX fees and policy"
4642,3,3,3,2014-08-06T15:49:16Z,2014-08-06T21:11:47Z,1,0,1,1,0,1,1,2,{'LD4': 1},1,0,{'LD4': 1},GUI
4644,4,0.08,2,2014-08-06T21:04:59Z,2014-09-25T07:38:12Z,50,48,2,0.04,1,2,2,2,"{'LD2': 1, 'LD4': 1}",2,0,"{'LD2': 1, 'LD4': 1}",GUI
4658,3,0.024193548,1,2014-08-08T07:15:41Z,2014-12-09T13:06:14Z,124,121,3,0.024193548,3,1,0,3,{},0,1,{},"Build system,Windows"
4660,1,1,1,2014-08-08T08:37:53Z,2014-08-08T08:52:31Z,1,0,1,1,0,1,0,1,{},0,1,{},
4669,8,0.121212121,4,2014-08-10T01:16:43Z,2014-10-14T09:35:32Z,66,64,2,0.03030303,2,5,1,7,{'LD3': 1},1,4,{'LD3': 1},"Bug,P2P"
4676,7,0.003661088,1.75,2014-08-11T07:36:51Z,2019-11-04T15:42:28Z,1912,1908,4,0.00209205,4,5,2,5,"{'LD3': 1, 'LD5': 1}",2,3,"{'LD3': 1, 'LD5': 1}",Refactoring
4677,10,0.01146789,5,2014-08-11T16:20:03Z,2016-12-30T16:07:01Z,872,870,2,0.002293578,2,6,3,7,"{'LD1': 2, 'LD3': 1}",3,3,"{'LD1': 2, 'LD3': 1}","Brainstorming,P2P"
4679,3,1.5,3,2014-08-11T18:54:34Z,2014-08-13T10:01:16Z,2,1,1,0.5,1,2,0,3,{},0,2,{},Bug
4693,1,0.00877193,1,2014-08-13T11:53:27Z,2014-12-05T11:48:28Z,114,113,1,0.00877193,1,1,1,0,{'LD3': 1},1,0,{'LD3': 1},
4703,13,0.115044248,2.6,2014-08-15T11:02:44Z,2014-12-05T11:45:09Z,113,108,5,0.044247788,4,7,8,5,"{'LD4': 3, 'LD3': 1, 'LD1': 4}",5,2,"{'LD4': 2, 'LD3': 1, 'LD1': 3}",
4705,1,0.25,1,2014-08-15T20:28:00Z,2014-08-19T17:37:25Z,4,3,1,0.25,1,1,0,1,{},0,1,{},"Bug,GUI,macOS"
4708,2,0.5,2,2014-08-16T00:38:24Z,2014-08-19T17:43:59Z,4,3,1,0.25,1,1,0,2,{},0,1,{},"Bug,Tests,macOS"
4720,1,1,1,2014-08-18T10:41:59Z,2014-08-18T10:51:14Z,1,0,1,1,0,1,1,0,{'LD3': 1},1,0,{'LD3': 1},
4721,1,0.001569859,1,2014-08-18T11:32:08Z,2016-05-15T13:01:16Z,637,636,1,0.001569859,2,1,1,0,{'LD4': 1},1,0,{'LD4': 1},Tests
4734,3,0.1,3,2014-08-20T08:06:04Z,2014-09-19T06:27:58Z,30,29,1,0.033333333,1,3,0,3,{},0,3,{},
4745,2,0.004464286,2,2014-08-21T05:19:49Z,2015-11-11T11:33:03Z,448,447,1,0.002232143,1,1,1,1,{'LD1': 1},1,0,{'LD1': 1},Build system
4746,1,1,1,2014-08-21T12:54:28Z,2014-08-21T13:05:39Z,1,0,1,1,0,1,0,1,{},0,1,{},
4747,1,0.009433962,1,2014-08-21T12:55:54Z,2014-12-05T11:45:52Z,106,105,1,0.009433962,1,1,1,0,{'LD1': 1},1,0,{'LD1': 1},
4750,1,1,1,2014-08-22T05:04:54Z,2014-08-22T18:31:32Z,1,0,1,1,0,1,0,1,{},0,1,{},
4756,1,0.066666667,1,2014-08-23T11:22:41Z,2014-09-06T19:10:36Z,15,14,1,0.066666667,2,1,0,1,{},0,1,{},Bug
4759,1,0.111111111,1,2014-08-24T07:54:47Z,2014-09-01T10:34:26Z,9,8,1,0.111111111,1,1,1,0,{'LD3': 1},1,0,{'LD3': 1},
4760,1,0.333333333,1,2014-08-24T08:03:42Z,2014-08-26T08:10:30Z,3,2,1,0.333333333,1,1,0,1,{},0,1,{},
4771,2,2,2,2014-08-27T22:01:44Z,2014-08-27T23:52:44Z,1,0,1,1,0,1,0,2,{},0,1,{},
4773,6,0.011299435,3,2014-08-28T02:13:02Z,2016-02-09T16:13:05Z,531,529,2,0.003766478,2,3,3,3,"{'LD4': 1, 'LD3': 2}",1,2,"{'LD4': 1, 'LD3': 1}",P2P
4774,1,0.2,1,2014-08-28T07:03:04Z,2014-09-01T08:19:29Z,5,4,1,0.2,1,1,0,1,{},0,1,{},
4791,4,0.040816327,1.333333333,2014-08-30T02:31:34Z,2014-12-05T11:44:28Z,98,95,3,0.030612245,3,2,1,3,{'LD1': 1},1,1,{'LD1': 1},
4792,2,2,2,2014-08-30T05:13:32Z,2014-08-30T13:01:58Z,1,0,1,1,0,1,0,2,{},0,1,{},
4797,2,0.5,1,2014-08-30T23:46:21Z,2014-09-03T04:40:29Z,4,2,2,0.5,1,1,0,2,{},0,1,{},
4799,4,0.041237113,1,2014-08-31T05:01:11Z,2014-12-05T11:42:57Z,97,93,4,0.041237113,2,3,2,2,"{'LD6': 1, 'LD5': 1}",1,2,"{'LD6': 1, 'LD5': 1}",
4807,2,2,2,2014-09-01T13:49:55Z,2014-09-01T14:33:48Z,1,0,1,1,0,2,1,1,{'LD1': 1},1,1,{'LD1': 1},
4818,1,0.002380952,1,2014-09-02T14:51:23Z,2015-10-27T10:58:50Z,420,419,1,0.002380952,2,1,0,1,{},0,1,{},Bug
4819,8,0.347826087,2,2014-09-02T15:17:18Z,2014-09-25T08:55:08Z,23,19,4,0.173913043,1,2,3,5,"{'LD4': 2, 'LD2': 1}",2,0,"{'LD4': 2, 'LD2': 1}","Build system,macOS"
4826,1,0.001180638,1,2014-09-03T03:09:40Z,2016-12-27T16:04:13Z,847,846,1,0.001180638,2,1,0,1,{},0,1,{},GUI
4840,6,0.046875,3,2014-09-04T10:04:04Z,2015-01-10T06:54:18Z,128,126,2,0.015625,2,3,1,5,{'LD4': 1},1,2,{'LD4': 1},"GUI,Windows"
4841,1,0.005952381,1,2014-09-04T10:28:26Z,2015-02-18T16:26:28Z,168,167,1,0.005952381,2,1,0,1,{},0,1,{},P2P
4844,5,0.003837299,2.5,2014-09-04T19:39:19Z,2018-03-30T06:22:31Z,1303,1301,2,0.001534919,2,2,0,5,{},0,2,{},"Brainstorming,RPC/REST/ZMQ"
4847,3,0.142857143,1,2014-09-05T06:53:32Z,2014-09-25T07:40:39Z,21,18,3,0.142857143,2,1,1,2,{'LD5': 1},1,0,{'LD5': 1},
4854,9,1.8,4.5,2014-09-05T13:08:38Z,2014-09-10T08:55:56Z,5,3,2,0.4,2,3,5,4,"{'LD4': 3, 'LD3': 2}",3,0,"{'LD4': 2, 'LD3': 2}","GUI,macOS"
4858,5,0.357142857,1.666666667,2014-09-05T18:44:54Z,2014-09-18T21:13:15Z,14,11,3,0.214285714,2,2,3,2,"{'LD1': 2, 'LD6': 1}",2,0,"{'LD1': 2, 'LD6': 1}",
4859,1,0.111111111,1,2014-09-06T06:47:36Z,2014-09-14T07:01:22Z,9,8,1,0.111111111,1,1,0,1,{},0,1,{},
4866,4,0.054794521,1.333333333,2014-09-08T06:55:16Z,2014-11-19T10:18:26Z,73,70,3,0.04109589,3,2,4,0,"{'LD4': 3, 'LD6': 1}",2,0,"{'LD4': 2, 'LD6': 1}","GUI,Wallet"
4870,1,0.028571429,1,2014-09-08T13:34:15Z,2014-10-13T11:57:20Z,35,34,1,0.028571429,1,1,0,1,{},0,1,{},"Bug,Wallet"
4872,1,0.000485437,1,2014-09-08T15:25:41Z,2020-04-29T13:43:20Z,2060,2059,1,0.000485437,2,1,1,0,{'LD4': 1},1,0,{'LD4': 1},"Bug,Docs"
4877,3,0.006993007,3,2014-09-09T03:30:05Z,2015-11-11T11:37:13Z,429,428,1,0.002331002,1,2,2,1,"{'LD4': 1, 'LD1': 1}",1,1,"{'LD4': 1, 'LD1': 1}",macOS
4884,6,3,6,2014-09-09T13:02:00Z,2014-09-11T06:56:52Z,2,1,1,0.5,1,4,0,6,{},0,4,{},
4886,3,0.428571429,1.5,2014-09-09T22:51:19Z,2014-09-16T09:44:26Z,7,5,2,0.285714286,1,3,2,1,{'LD5': 2},2,1,{'LD5': 2},
4888,1,1,1,2014-09-10T08:17:49Z,2014-09-10T08:28:29Z,1,0,1,1,0,1,0,1,{},0,1,{},
4893,1,0.5,1,2014-09-10T23:23:43Z,2014-09-12T17:05:09Z,2,1,1,0.5,1,1,0,1,{},0,1,{},
4894,1,1,1,2014-09-10T23:49:40Z,2014-09-11T06:29:26Z,1,0,1,1,0,1,1,0,{'LD1': 1},1,0,{'LD1': 1},
4900,2,2,2,2014-09-12T06:38:06Z,2014-09-12T15:10:00Z,1,0,1,1,0,2,1,1,{'LD4': 1},1,1,{'LD4': 1},
4901,3,0.230769231,1.5,2014-09-12T09:52:53Z,2014-09-25T07:39:48Z,13,11,2,0.153846154,1,2,2,1,{'LD4': 2},2,0,{'LD4': 2},GUI
4904,6,0.461538462,6,2014-09-12T15:58:41Z,2014-09-25T07:38:42Z,13,12,1,0.076923077,1,2,1,5,{'LD1': 1},1,1,{'LD1': 1},
4905,5,0.002431907,1.25,2014-09-12T23:41:27Z,2020-04-29T13:51:26Z,2056,2052,4,0.001945525,3,4,1,4,{'LD1': 1},1,3,{'LD1': 1},"Feature,Tests"
4907,7,0.368421053,3.5,2014-09-13T09:48:33Z,2014-10-02T06:25:23Z,19,17,2,0.105263158,1,5,4,3,"{'LD4': 2, 'LD3': 1, 'LD5': 1}",4,1,"{'LD4': 2, 'LD3': 1, 'LD5': 1}",Tests
4908,2,0.001118568,1,2014-09-14T01:26:26Z,2019-08-06T06:34:39Z,1788,1786,2,0.001118568,3,2,0,2,{},0,2,{},"Bug,GUI"
4910,4,0.007782101,2,2014-09-14T06:39:36Z,2016-02-09T16:12:23Z,514,512,2,0.003891051,2,3,1,3,{'LD1': 1},1,2,{'LD1': 1},P2P
4915,3,0.272727273,1.5,2014-09-15T03:07:11Z,2014-09-25T07:37:57Z,11,9,2,0.181818182,2,2,2,1,"{'LD4': 1, 'LD3': 1}",1,1,"{'LD4': 1, 'LD3': 1}",GUI
4918,1,1,1,2014-09-15T07:16:36Z,2014-09-15T07:38:36Z,1,0,1,1,0,1,0,1,{},0,1,{},
4923,2,1,2,2014-09-15T16:55:47Z,2014-09-16T19:25:00Z,2,1,1,0.5,1,2,1,1,{'LD3': 1},1,1,{'LD3': 1},
4924,3,1,1.5,2014-09-15T18:26:13Z,2014-09-18T07:16:59Z,3,1,2,0.666666667,1,3,0,3,{},0,3,{},
4935,2,0.000975134,1,2014-09-17T22:09:49Z,2020-04-29T13:45:44Z,2051,2049,2,0.000975134,3,1,1,1,{'LD6': 1},1,0,{'LD6': 1},"Docs,Linux/Unix"
4943,1,0.000789889,1,2014-09-18T16:37:07Z,2018-03-06T22:13:42Z,1266,1265,1,0.000789889,1,1,1,0,{'LD5': 1},1,0,{'LD5': 1},"Brainstorming,TX fees and policy"
4945,13,1,2.166666667,2014-09-19T03:39:37Z,2014-10-01T13:46:39Z,13,7,6,0.461538462,3,4,6,7,"{'LD4': 2, 'LD1': 3, 'LD3': 1}",2,2,"{'LD4': 1, 'LD1': 2, 'LD3': 1}",
4948,7,3.5,7,2014-09-19T23:49:40Z,2014-09-21T19:34:59Z,2,1,1,0.5,1,3,1,6,{'LD1': 1},1,2,{'LD1': 1},
4971,5,5,5,2014-09-24T11:31:18Z,2014-09-25T06:16:44Z,1,0,1,1,0,3,1,4,{'LD2': 1},1,2,{'LD2': 1},
4972,2,2,2,2014-09-24T16:38:44Z,2014-09-25T07:37:12Z,1,0,1,1,0,2,0,2,{},0,2,{},
4975,2,0.027777778,2,2014-09-24T23:02:48Z,2014-12-05T11:38:55Z,72,71,1,0.013888889,1,2,1,1,{'LD3': 1},1,1,{'LD3': 1},
4992,16,3.2,5.333333333,2014-09-27T20:17:46Z,2014-10-01T21:59:04Z,5,2,3,0.6,1,7,5,11,"{'LD3': 2, 'LD4': 2, 'LD1': 1}",4,3,"{'LD3': 2, 'LD4': 2, 'LD1': 1}",macOS
4993,6,2,2,2014-09-28T04:00:04Z,2014-09-30T17:55:15Z,3,0,3,1,0,2,3,3,"{'LD4': 2, 'LD1': 1}",1,1,"{'LD4': 1, 'LD1': 1}",
4997,7,0.019337017,2.333333333,2014-09-28T16:04:55Z,2015-09-25T13:35:01Z,362,359,3,0.008287293,2,3,2,5,"{'LD3': 1, 'LD1': 1}",2,1,"{'LD3': 1, 'LD1': 1}",Build system
4998,2,2,2,2014-09-28T19:58:44Z,2014-09-29T07:27:10Z,1,0,1,1,0,2,2,0,"{'LD4': 1, 'LD1': 1}",2,0,"{'LD4': 1, 'LD1': 1}",
5016,1,1,1,2014-09-30T23:15:18Z,2014-09-30T23:31:17Z,1,0,1,1,0,1,0,1,{},0,1,{},
5021,1,1,1,2014-10-01T08:30:12Z,2014-10-01T10:56:28Z,1,0,1,1,0,1,0,1,{},0,1,{},
5037,8,0.080808081,1.333333333,2014-10-03T00:24:36Z,2015-01-09T20:53:17Z,99,93,6,0.060606061,4,3,1,7,{'LD4': 1},1,2,{'LD4': 1},GUI
5046,2,2,2,2014-10-05T06:08:04Z,2014-10-06T02:16:53Z,1,0,1,1,0,2,1,1,{'LD4': 1},1,1,{'LD4': 1},
5052,2,2,2,2014-10-06T19:05:41Z,2014-10-06T19:10:56Z,1,0,1,1,0,2,0,2,{},0,2,{},
5062,3,3,3,2014-10-08T03:45:35Z,2014-10-08T05:10:08Z,1,0,1,1,0,2,2,1,"{'LD4': 1, 'LD3': 1}",2,0,"{'LD4': 1, 'LD3': 1}",
5064,8,2.666666667,8,2014-10-08T19:31:19Z,2014-10-11T08:48:52Z,3,2,1,0.333333333,1,2,3,5,"{'LD1': 1, 'LD6': 1, 'LD4': 1}",2,0,"{'LD1': 1, 'LD6': 1, 'LD4': 1}",
5068,9,0.018145161,1.285714286,2014-10-09T12:04:49Z,2016-02-16T17:12:59Z,496,489,7,0.014112903,4,5,4,5,"{'LD4': 2, 'LD3': 2}",3,2,"{'LD4': 2, 'LD3': 2}",Docs
5070,2,0.002773925,1,2014-10-10T02:14:47Z,2016-09-29T09:22:00Z,721,719,2,0.002773925,3,2,1,1,{'LD6': 1},1,1,{'LD6': 1},"RPC/REST/ZMQ,Resource usage"
5083,4,0.19047619,4,2014-10-13T21:44:55Z,2014-11-03T11:22:53Z,21,20,1,0.047619048,1,1,2,2,"{'LD3': 1, 'LD1': 1}",1,0,"{'LD3': 1, 'LD1': 1}",
5094,2,0.5,2,2014-10-16T22:17:30Z,2014-10-20T09:37:02Z,4,3,1,0.25,2,2,1,1,{'LD6': 1},1,1,{'LD6': 1},
5101,1,0.004716981,1,2014-10-18T08:44:11Z,2015-05-18T08:29:15Z,212,211,1,0.004716981,1,1,0,1,{},0,1,{},GUI
5109,1,0.043478261,1,2014-10-20T11:54:30Z,2014-11-11T13:40:48Z,23,22,1,0.043478261,2,1,1,0,{'LD3': 1},1,0,{'LD3': 1},GUI
5113,3,0.0375,1.5,2014-10-21T07:09:36Z,2015-01-08T13:25:27Z,80,78,2,0.025,2,3,2,1,"{'LD4': 1, 'LD3': 1}",2,1,"{'LD4': 1, 'LD3': 1}",Bug
5120,4,0.004504505,2,2014-10-22T22:07:19Z,2017-03-28T02:47:47Z,888,886,2,0.002252252,2,3,3,1,"{'LD4': 2, 'LD1': 1}",3,0,"{'LD4': 2, 'LD1': 1}",RPC/REST/ZMQ
5124,1,1,1,2014-10-23T10:40:08Z,2014-10-23T10:44:03Z,1,0,1,1,0,1,0,1,{},0,1,{},
5126,4,0.059701493,2,2014-10-23T16:47:52Z,2014-12-29T08:51:14Z,67,65,2,0.029850746,2,2,3,1,"{'LD4': 1, 'LD3': 1, 'LD5': 1}",1,1,"{'LD4': 1, 'LD3': 1, 'LD5': 1}","Bug,macOS"
5127,3,1.5,3,2014-10-23T17:06:30Z,2014-10-24T17:45:59Z,2,1,1,0.5,1,2,0,3,{},0,2,{},"Bug,Tests"
5129,1,0.166666667,1,2014-10-23T19:03:42Z,2014-10-29T11:00:01Z,6,5,1,0.166666667,1,1,1,0,{'LD3': 1},1,0,{'LD3': 1},
5136,1,1,1,2014-10-24T14:55:26Z,2014-10-24T15:02:36Z,1,0,1,1,0,1,0,1,{},0,1,{},
5138,6,0.027272727,1.5,2014-10-24T19:06:56Z,2015-06-01T08:53:27Z,220,216,4,0.018181818,3,5,2,4,{'LD2': 2},1,4,{'LD2': 1},Bug
5147,7,0.170731707,3.5,2014-10-26T09:48:38Z,2014-12-05T11:37:55Z,41,39,2,0.048780488,1,2,4,3,"{'LD1': 1, 'LD4': 1, 'LD6': 1, 'LD3': 1}",2,0,"{'LD1': 1, 'LD4': 1, 'LD6': 1, 'LD3': 1}",
5150,5,0.002228164,5,2014-10-27T10:55:35Z,2020-12-17T11:10:31Z,2244,2243,1,0.000445633,1,4,3,2,"{'LD4': 1, 'LD3': 2}",3,1,"{'LD4': 1, 'LD3': 2}",P2P
5156,4,0.105263158,2,2014-10-28T16:14:17Z,2014-12-05T11:36:07Z,38,36,2,0.052631579,2,2,3,1,"{'LD3': 2, 'LD2': 1}",2,0,"{'LD3': 1, 'LD2': 1}",
5160,13,0.033505155,4.333333333,2014-10-28T20:31:55Z,2015-11-20T07:26:24Z,388,385,3,0.007731959,1,7,3,10,"{'LD3': 1, 'LD4': 1, 'LD1': 1}",3,4,"{'LD3': 1, 'LD4': 1, 'LD1': 1}",
5163,3,0.001338091,1,2014-10-29T01:42:07Z,2020-12-17T08:03:38Z,2242,2239,3,0.001338091,2,3,1,2,{'LD4': 1},1,2,{'LD4': 1},Refactoring
5165,5,0.044247788,1.25,2014-10-29T04:22:15Z,2015-02-18T16:32:57Z,113,109,4,0.03539823,3,3,1,4,{'LD3': 1},1,2,{'LD3': 1},
5177,1,0.142857143,1,2014-10-30T13:34:53Z,2014-11-06T12:13:40Z,7,6,1,0.142857143,1,1,1,0,{'LD2': 1},1,0,{'LD2': 1},Build system
5189,2,0.018181818,1,2014-11-01T09:01:17Z,2015-02-18T16:34:19Z,110,108,2,0.018181818,2,2,2,0,"{'LD3': 1, 'LD4': 1}",2,0,"{'LD3': 1, 'LD4': 1}",
5197,1,1,1,2014-11-02T11:47:02Z,2014-11-03T07:40:42Z,1,0,1,1,0,1,0,1,{},0,1,{},
5202,3,0.004322767,1,2014-11-03T22:32:01Z,2016-09-27T19:45:56Z,694,691,3,0.004322767,4,1,2,1,{'LD2': 2},1,0,{'LD2': 1},Wallet
5204,10,0.005760369,1.25,2014-11-04T13:17:27Z,2019-08-06T06:34:27Z,1736,1728,8,0.004608295,7,6,2,8,"{'LD2': 1, 'LD3': 1}",2,4,"{'LD2': 1, 'LD3': 1}","Brainstorming,GUI,Wallet"
5233,1,1,1,2014-11-07T01:25:04Z,2014-11-07T08:26:26Z,1,0,1,1,0,1,0,1,{},0,1,{},
5244,1,0.037037037,1,2014-11-08T14:52:12Z,2014-12-05T11:33:44Z,27,26,1,0.037037037,1,1,1,0,{'LD2': 1},1,0,{'LD2': 1},
5250,9,0.176470588,1.8,2014-11-09T04:06:07Z,2014-12-29T08:56:59Z,51,46,5,0.098039216,1,4,4,5,"{'LD4': 1, 'LD3': 2, 'LD5': 1}",2,2,"{'LD4': 1, 'LD3': 1, 'LD5': 1}",macOS
5260,4,0.01038961,1.333333333,2014-11-11T09:49:42Z,2015-11-30T14:09:14Z,385,382,3,0.007792208,3,2,2,2,"{'LD3': 1, 'LD4': 1}",2,0,"{'LD3': 1, 'LD4': 1}","GUI,Upstream"
5262,8,0.296296296,2,2014-11-12T06:23:37Z,2014-12-08T08:23:54Z,27,23,4,0.148148148,1,4,3,5,"{'LD3': 1, 'LD5': 2}",2,2,"{'LD3': 1, 'LD5': 2}",Bug
5263,1,1,1,2014-11-12T10:18:25Z,2014-11-12T10:22:28Z,1,0,1,1,0,1,0,1,{},0,1,{},
5265,4,4,4,2014-11-12T20:19:45Z,2014-11-12T21:27:44Z,1,0,1,1,0,4,0,4,{},0,4,{},
5271,2,1,1,2014-11-13T13:05:59Z,2014-11-14T17:35:13Z,2,0,2,1,0,1,2,0,{'LD3': 2},1,0,{'LD3': 1},"Bug,GUI"
5274,1,1,1,2014-11-13T14:44:57Z,2014-11-14T11:08:26Z,1,0,1,1,0,1,0,1,{},0,1,{},
5277,2,0.010752688,1,2014-11-14T05:38:12Z,2015-05-18T08:27:22Z,186,184,2,0.010752688,2,2,0,2,{},0,2,{},Bug
5278,3,0.001506781,1.5,2014-11-14T08:05:47Z,2020-04-27T00:13:14Z,1991,1989,2,0.00100452,2,3,1,2,{'LD1': 1},1,2,{'LD1': 1},"Feature,GUI"
5284,2,0.004357298,1,2014-11-15T09:34:11Z,2016-02-16T17:12:39Z,459,457,2,0.004357298,2,2,1,1,{'LD5': 1},1,1,{'LD5': 1},Brainstorming
5311,5,0.002779322,1.25,2014-11-19T11:13:10Z,2019-10-22T14:26:21Z,1799,1795,4,0.002223457,2,4,2,3,{'LD3': 2},2,2,{'LD3': 2},Docs
5315,1,1,1,2014-11-19T15:47:11Z,2014-11-19T19:09:27Z,1,0,1,1,0,1,0,1,{},0,1,{},
5330,2,2,2,2014-11-20T16:07:14Z,2014-11-20T16:20:11Z,1,0,1,1,0,1,1,1,{'LD6': 1},1,0,{'LD6': 1},Bug
5331,1,1,1,2014-11-20T17:17:38Z,2014-11-21T12:55:30Z,1,0,1,1,0,1,1,0,{'LD1': 1},1,0,{'LD1': 1},
5336,2,2,2,2014-11-21T02:59:43Z,2014-11-21T08:58:53Z,1,0,1,1,0,2,2,0,"{'LD2': 1, 'LD3': 1}",2,0,"{'LD2': 1, 'LD3': 1}",
5338,2,0.333333333,2,2014-11-21T08:45:45Z,2014-11-26T08:51:20Z,6,5,1,0.166666667,1,1,0,2,{},0,1,{},Build system
5339,2,0.00990099,1,2014-11-21T08:52:21Z,2015-06-10T15:40:47Z,202,200,2,0.00990099,2,1,1,1,{'LD3': 1},1,0,{'LD3': 1},"Build system,GUI"
5343,2,0.4,1,2014-11-21T17:00:39Z,2014-11-26T11:33:10Z,5,3,2,0.4,1,1,1,1,{'LD3': 1},1,0,{'LD3': 1},Build system
5346,1,0.1,1,2014-11-21T21:32:06Z,2014-12-01T11:44:43Z,10,9,1,0.1,1,1,0,1,{},0,1,{},Wallet
5352,1,0.000505051,1,2014-11-23T01:46:20Z,2020-04-24T20:09:56Z,1980,1979,1,0.000505051,1,1,1,0,{'LD4': 1},1,0,{'LD4': 1},P2P
5353,5,0.125,1.25,2014-11-23T07:05:09Z,2015-01-01T23:30:41Z,40,36,4,0.1,5,2,5,0,"{'LD3': 1, 'LD1': 2, 'LD5': 1, 'LD2': 1}",2,0,"{'LD3': 1, 'LD1': 2, 'LD5': 1, 'LD2': 1}",macOS
5355,1,0.25,1,2014-11-23T11:35:20Z,2014-11-27T08:19:44Z,4,3,1,0.25,1,1,0,1,{},0,1,{},Bug
5359,4,1.333333333,4,2014-11-24T09:35:44Z,2014-11-26T09:56:02Z,3,2,1,0.333333333,1,3,0,4,{},0,3,{},
5364,2,0.011111111,2,2014-11-25T07:10:31Z,2015-05-23T20:06:21Z,180,179,1,0.005555556,2,1,1,1,{'LD4': 1},1,0,{'LD4': 1},
5375,1,0.1,1,2014-11-26T10:23:05Z,2014-12-05T11:24:26Z,10,9,1,0.1,1,1,0,1,{},0,1,{},
5377,8,0.02359882,1.6,2014-11-26T14:30:27Z,2015-10-31T11:28:39Z,339,334,5,0.014749263,3,5,1,7,{'LD5': 1},1,4,{'LD5': 1},
5378,5,0.03125,1.666666667,2014-11-26T14:33:11Z,2015-05-05T06:44:45Z,160,157,3,0.01875,3,2,2,3,"{'LD1': 1, 'LD4': 1}",2,0,"{'LD1': 1, 'LD4': 1}","Docs,GUI"
5380,3,0.001506781,1,2014-11-26T15:46:53Z,2020-05-09T12:35:02Z,1991,1988,3,0.001506781,4,2,2,1,"{'LD4': 1, 'LD5': 1}",2,0,"{'LD4': 1, 'LD5': 1}","Bug,Resource usage"
5397,1,0.000838223,1,2014-11-30T23:53:51Z,2018-03-07T21:12:59Z,1193,1192,1,0.000838223,2,1,1,0,{'LD4': 1},1,0,{'LD4': 1},Tests
5405,1,0.001501502,1,2014-12-02T15:00:18Z,2016-09-28T08:21:01Z,666,665,1,0.001501502,1,1,1,0,{'LD4': 1},1,0,{'LD4': 1},"Mining,Tests"
5412,2,0.002166847,1,2014-12-03T07:39:19Z,2017-06-13T00:27:45Z,923,921,2,0.002166847,1,2,2,0,"{'LD3': 1, 'LD5': 1}",2,0,"{'LD3': 1, 'LD5': 1}",RPC/REST/ZMQ
5428,1,0.125,1,2014-12-05T06:38:52Z,2014-12-12T10:36:34Z,8,7,1,0.125,2,1,1,0,{'LD3': 1},1,0,{'LD3': 1},Build system
5447,1,0.002298851,1,2014-12-08T16:09:01Z,2016-02-16T13:08:04Z,435,434,1,0.002298851,1,1,0,1,{},0,1,{},
5454,3,0.375,1,2014-12-09T17:40:26Z,2014-12-17T09:54:49Z,8,5,3,0.375,2,2,3,0,"{'LD3': 1, 'LD5': 2}",2,0,"{'LD3': 1, 'LD5': 2}",
5456,2,1,2,2014-12-10T12:47:46Z,2014-12-11T14:59:20Z,2,1,1,0.5,1,2,2,0,{'LD3': 2},2,0,{'LD3': 2},"Bug,Tests"
5462,2,0.0625,1,2014-12-11T18:56:56Z,2015-01-12T10:38:55Z,32,30,2,0.0625,2,1,1,1,{'LD3': 1},1,0,{'LD3': 1},
5472,1,1,1,2014-12-13T14:39:27Z,2014-12-13T21:24:03Z,1,0,1,1,0,1,0,1,{},0,1,{},
5495,4,0.210526316,1.333333333,2014-12-17T04:28:46Z,2015-01-04T16:38:45Z,19,16,3,0.157894737,1,2,1,3,{'LD3': 1},1,1,{'LD3': 1},
5526,4,0.014084507,1,2014-12-22T14:05:18Z,2015-10-01T19:47:55Z,284,280,4,0.014084507,3,4,1,3,{'LD5': 1},1,3,{'LD5': 1},
5538,12,0.00660793,4,2014-12-24T21:43:57Z,2019-12-14T18:04:45Z,1816,1813,3,0.001651982,2,6,2,10,"{'LD4': 1, 'LD2': 1}",2,4,"{'LD4': 1, 'LD2': 1}",Mining
5539,1,1,1,2014-12-25T00:34:54Z,2014-12-25T13:13:46Z,1,0,1,1,0,1,1,0,{'LD1': 1},1,0,{'LD1': 1},
5550,2,0.026666667,2,2014-12-27T18:26:11Z,2015-03-12T05:21:31Z,75,74,1,0.013333333,2,1,2,0,{'LD1': 2},1,0,{'LD1': 1},Wallet
5552,1,0.007042254,1,2014-12-27T21:24:44Z,2015-05-18T08:25:48Z,142,141,1,0.007042254,1,1,1,0,{'LD1': 1},1,0,{'LD1': 1},
5553,3,1.5,3,2014-12-28T06:21:34Z,2014-12-29T09:38:01Z,2,1,1,0.5,1,1,1,2,{'LD5': 1},1,0,{'LD5': 1},
5555,1,0.090909091,1,2014-12-28T15:57:36Z,2015-01-08T11:55:24Z,11,10,1,0.090909091,1,1,1,0,{'LD5': 1},1,0,{'LD5': 1},
5560,5,2.5,2.5,2014-12-29T00:23:32Z,2014-12-30T16:39:19Z,2,0,2,1,0,1,3,2,"{'LD4': 2, 'LD2': 1}",1,0,"{'LD4': 1, 'LD2': 1}",Windows
5563,4,1.333333333,2,2014-12-29T19:20:11Z,2015-01-01T10:55:05Z,3,1,2,0.666666667,1,3,0,4,{},0,3,{},
5567,2,0.166666667,1,2014-12-30T00:20:45Z,2015-01-10T22:28:52Z,12,10,2,0.166666667,2,2,1,1,{'LD1': 1},1,1,{'LD1': 1},"Wallet,macOS"
5568,1,0.142857143,1,2014-12-30T02:47:10Z,2015-01-05T08:44:52Z,7,6,1,0.142857143,2,1,1,0,{'LD1': 1},1,0,{'LD1': 1},"Data corruption,UTXO Db and Indexes"
5570,3,0.25,1,2014-12-30T08:25:22Z,2015-01-10T09:27:20Z,12,9,3,0.25,3,3,1,2,{'LD4': 1},1,2,{'LD4': 1},GUI
5572,5,0.035971223,1,2014-12-30T12:03:21Z,2015-05-18T08:53:58Z,139,134,5,0.035971223,2,2,2,3,{'LD4': 2},2,0,{'LD4': 2},"Feature,Wallet"
5584,1,0.000564972,1,2014-12-31T14:11:18Z,2019-11-04T15:43:08Z,1770,1769,1,0.000564972,2,1,0,1,{},0,1,{},"Feature,RPC/REST/ZMQ,Wallet"
5588,15,0.109489051,3,2015-01-01T09:34:59Z,2015-05-18T08:51:49Z,137,132,5,0.03649635,2,7,4,11,"{'LD4': 3, 'LD3': 1}",3,4,"{'LD4': 2, 'LD3': 1}","Bug,P2P"
5596,1,0.2,1,2015-01-04T03:16:51Z,2015-01-08T13:11:39Z,5,4,1,0.2,1,1,1,0,{'LD4': 1},1,0,{'LD4': 1},
5601,3,3,3,2015-01-05T01:47:20Z,2015-01-05T08:17:56Z,1,0,1,1,0,3,1,2,{'LD5': 1},1,2,{'LD5': 1},
5605,6,0.014742015,3,2015-01-06T12:25:03Z,2016-02-16T15:33:28Z,407,405,2,0.004914005,2,4,1,5,{'LD3': 1},1,3,{'LD3': 1},Build system
5609,1,0.5,1,2015-01-06T21:30:54Z,2015-01-08T11:22:21Z,2,1,1,0.5,1,1,1,0,{'LD5': 1},1,0,{'LD5': 1},
5610,12,0.018662519,1.333333333,2015-01-06T23:04:17Z,2016-10-10T09:48:47Z,643,634,9,0.01399689,5,7,2,10,"{'LD5': 1, 'LD4': 1}",1,6,"{'LD5': 1, 'LD4': 1}","Data corruption,Windows"
5622,2,0.006849315,2,2015-01-08T17:12:28Z,2015-10-27T11:33:58Z,292,291,1,0.003424658,1,2,2,0,"{'LD2': 1, 'LD5': 1}",2,0,"{'LD2': 1, 'LD5': 1}",
5624,2,0.0625,2,2015-01-09T09:25:21Z,2015-02-09T12:51:08Z,32,31,1,0.03125,1,1,0,2,{},0,1,{},GUI
5625,6,1,3,2015-01-09T10:30:50Z,2015-01-14T17:11:24Z,6,4,2,0.333333333,2,3,1,5,{'LD2': 1},1,2,{'LD2': 1},GUI
5631,8,0.005970149,1.6,2015-01-09T16:08:52Z,2018-09-10T03:39:18Z,1340,1335,5,0.003731343,4,6,1,7,{'LD3': 1},1,5,{'LD3': 1},"Bug,Upstream"
5633,3,0.023255814,1.5,2015-01-09T21:36:21Z,2015-05-18T08:53:34Z,129,127,2,0.015503876,2,2,2,1,"{'LD3': 1, 'LD1': 1}",2,0,"{'LD3': 1, 'LD1': 1}",
5638,1,0.000451671,1,2015-01-10T19:07:27Z,2021-02-01T10:00:35Z,2214,2213,1,0.000451671,2,1,1,0,{'LD3': 1},1,0,{'LD3': 1},RPC/REST/ZMQ
5639,6,0.005208333,1.5,2015-01-11T00:38:19Z,2018-03-07T13:20:50Z,1152,1148,4,0.003472222,4,6,1,5,{'LD4': 1},1,5,{'LD4': 1},"Brainstorming,Feature,Validation"
5641,3,0.002606429,1.5,2015-01-11T14:24:19Z,2018-03-06T18:14:24Z,1151,1149,2,0.001737619,1,2,0,3,{},0,2,{},GUI
5645,1,1,1,2015-01-12T14:36:10Z,2015-01-12T16:40:06Z,1,0,1,1,0,1,1,0,{'LD1': 1},1,0,{'LD1': 1},Bug
5646,3,3,3,2015-01-12T17:27:03Z,2015-01-13T13:48:54Z,1,0,1,1,0,2,1,2,{'LD5': 1},1,1,{'LD5': 1},
5650,3,0.002586207,1.5,2015-01-12T22:04:18Z,2018-03-17T18:06:25Z,1160,1158,2,0.001724138,2,3,2,1,"{'LD3': 1, 'LD1': 1}",2,1,"{'LD3': 1, 'LD1': 1}",GUI
5653,2,0.0016,1,2015-01-13T07:52:34Z,2018-06-15T21:02:47Z,1250,1248,2,0.0016,2,2,1,1,{'LD4': 1},1,1,{'LD4': 1},GUI
5657,7,1.166666667,3.5,2015-01-14T08:19:11Z,2015-01-19T11:32:05Z,6,4,2,0.333333333,1,3,2,5,"{'LD3': 1, 'LD4': 1}",1,2,"{'LD3': 1, 'LD4': 1}","GUI,macOS"
5659,4,0.013986014,2,2015-01-14T14:04:44Z,2015-10-27T10:52:01Z,286,284,2,0.006993007,3,3,1,3,{'LD5': 1},1,2,{'LD5': 1},
5660,4,0.666666667,2,2015-01-14T19:06:42Z,2015-01-20T13:11:42Z,6,4,2,0.333333333,1,3,0,4,{},0,3,{},
5661,1,1,1,2015-01-14T19:55:48Z,2015-01-15T15:52:14Z,1,0,1,1,0,1,0,1,{},0,1,{},
5663,6,0.01875,1.5,2015-01-14T23:23:57Z,2015-11-30T14:02:22Z,320,316,4,0.0125,4,3,4,2,"{'LD4': 3, 'LD3': 1}",3,0,"{'LD4': 2, 'LD3': 1}",GUI
5664,4,0.0125,2,2015-01-15T02:53:18Z,2015-11-30T13:40:28Z,320,318,2,0.00625,3,3,2,2,"{'LD3': 1, 'LD2': 1}",1,2,"{'LD3': 1, 'LD2': 1}",GUI
5667,2,2,2,2015-01-15T18:10:22Z,2015-01-15T22:07:25Z,1,0,1,1,0,1,1,1,{'LD1': 1},1,0,{'LD1': 1},
5668,115,0.175038052,3.59375,2015-01-15T18:12:56Z,2016-11-02T11:41:30Z,657,625,32,0.04870624,22,22,42,73,"{'LD4': 20, 'LD6': 2, 'LD3': 16, 'LD1': 3, 'LD5': 1}",14,8,"{'LD4': 7, 'LD6': 2, 'LD3': 7, 'LD1': 3, 'LD5': 1}","Data corruption,UTXO Db and Indexes"
5672,1,1,1,2015-01-16T01:25:16Z,2015-01-16T02:27:38Z,1,0,1,1,0,1,1,0,{'LD4': 1},1,0,{'LD4': 1},
5676,2,0.016666667,1,2015-01-18T12:45:18Z,2015-05-18T09:05:21Z,120,118,2,0.016666667,2,2,0,2,{},0,2,{},
5678,2,0.003174603,2,2015-01-19T14:23:03Z,2016-10-10T08:24:52Z,630,629,1,0.001587302,1,1,1,1,{'LD3': 1},1,0,{'LD3': 1},"Bug,P2P"
5682,1,0.00054407,1,2015-01-19T20:09:12Z,2020-01-31T05:59:55Z,1838,1837,1,0.00054407,2,1,0,1,{},0,1,{},"Feature,GUI"
5687,1,1,1,2015-01-20T19:18:38Z,2015-01-21T18:53:01Z,1,0,1,1,0,1,1,0,{'LD1': 1},1,0,{'LD1': 1},
5690,1,1,1,2015-01-22T07:08:53Z,2015-01-22T08:08:23Z,1,0,1,1,0,1,1,0,{'LD1': 1},1,0,{'LD1': 1},
5698,1,1,1,2015-01-23T13:25:50Z,2015-01-24T12:03:12Z,1,0,1,1,0,1,0,1,{},0,1,{},
5703,2,0.142857143,2,2015-01-24T03:47:13Z,2015-02-06T15:51:52Z,14,13,1,0.071428571,2,2,1,1,{'LD3': 1},1,1,{'LD3': 1},
5712,2,0.005263158,2,2015-01-26T16:06:26Z,2016-02-09T16:11:19Z,380,379,1,0.002631579,2,2,1,1,{'LD4': 1},1,1,{'LD4': 1},Mining
5715,1,0.125,1,2015-01-27T05:45:27Z,2015-02-03T09:51:08Z,8,7,1,0.125,1,1,0,1,{},0,1,{},Bug
5716,4,1.333333333,2,2015-01-27T06:10:54Z,2015-01-29T10:14:51Z,3,1,2,0.666666667,1,3,0,4,{},0,3,{},GUI
5722,2,0.001212121,1,2015-01-29T08:24:14Z,2019-08-06T07:11:45Z,1650,1648,2,0.001212121,3,2,2,0,"{'LD4': 1, 'LD3': 1}",2,0,"{'LD4': 1, 'LD3': 1}","GUI,Wallet"
5724,3,3,3,2015-01-30T12:27:44Z,2015-01-30T14:19:34Z,1,0,1,1,0,1,1,2,{'LD3': 1},1,0,{'LD3': 1},
5725,2,0.5,1,2015-01-30T12:28:23Z,2015-02-03T08:49:40Z,4,2,2,0.5,1,2,0,2,{},0,2,{},GUI
5726,1,0.000606428,1,2015-01-30T12:29:07Z,2019-08-06T06:24:07Z,1649,1648,1,0.000606428,2,1,0,1,{},0,1,{},"GUI,Wallet"
5728,13,1.625,2.166666667,2015-01-31T08:49:35Z,2015-02-07T18:42:26Z,8,2,6,0.75,1,4,9,4,"{'LD1': 3, 'LD3': 2, 'LD5': 4}",3,1,"{'LD1': 1, 'LD3': 1, 'LD5': 2}","Upstream,macOS"
5741,4,2,2,2015-02-03T01:25:28Z,2015-02-04T07:08:43Z,2,0,2,1,0,2,1,3,{'LD5': 1},1,1,{'LD5': 1},"Build system,macOS"
5742,5,0.047619048,1.25,2015-02-03T03:06:30Z,2015-05-18T08:13:59Z,105,101,4,0.038095238,2,3,2,3,"{'LD3': 1, 'LD2': 1}",2,1,"{'LD3': 1, 'LD2': 1}",
5746,3,0.214285714,1,2015-02-03T21:11:57Z,2015-02-16T22:02:36Z,14,11,3,0.214285714,4,3,1,2,{'LD5': 1},1,2,{'LD5': 1},
5748,2,2,2,2015-02-04T06:19:03Z,2015-02-04T19:50:27Z,1,0,1,1,0,1,1,1,{'LD1': 1},1,0,{'LD1': 1},
5761,8,0.003686636,1.142857143,2015-02-05T08:31:45Z,2021-01-14T06:43:52Z,2170,2163,7,0.003225806,6,6,3,5,"{'LD4': 1, 'LD5': 2}",3,3,"{'LD4': 1, 'LD5': 2}","Brainstorming,Wallet"
5763,1,1,1,2015-02-06T06:10:48Z,2015-02-06T09:45:00Z,1,0,1,1,0,1,1,0,{'LD5': 1},1,0,{'LD5': 1},
5767,5,5,5,2015-02-07T20:14:01Z,2015-02-08T11:13:32Z,1,0,1,1,0,1,3,2,"{'LD4': 2, 'LD1': 1}",1,0,"{'LD4': 1, 'LD1': 1}",
5778,4,0.142857143,1.333333333,2015-02-09T13:04:34Z,2015-03-09T08:55:59Z,28,25,3,0.107142857,3,1,1,3,{'LD3': 1},1,0,{'LD3': 1},
5779,5,0.004456328,2.5,2015-02-09T23:51:38Z,2018-03-07T18:21:03Z,1122,1120,2,0.001782531,2,3,2,3,"{'LD3': 1, 'LD4': 1}",2,1,"{'LD3': 1, 'LD4': 1}","Brainstorming,Consensus"
5783,28,0.159090909,2.545454545,2015-02-10T17:50:34Z,2015-08-05T13:52:27Z,176,165,11,0.0625,5,12,7,21,"{'LD3': 2, 'LD4': 3, 'LD2': 1, 'LD1': 1}",5,7,"{'LD3': 2, 'LD4': 2, 'LD2': 1, 'LD1': 1}",Feature
5785,5,0.010040161,1.666666667,2015-02-10T23:36:36Z,2016-06-22T11:03:44Z,498,495,3,0.006024096,2,3,5,0,"{'LD4': 2, 'LD1': 2, 'LD3': 1}",3,0,"{'LD4': 2, 'LD1': 2, 'LD3': 1}",Mining
5786,2,1,2,2015-02-11T09:13:43Z,2015-02-12T16:53:42Z,2,1,1,0.5,1,2,2,0,"{'LD1': 1, 'LD4': 1}",2,0,"{'LD1': 1, 'LD4': 1}",
5789,3,3,3,2015-02-12T20:23:22Z,2015-02-13T08:44:30Z,1,0,1,1,0,2,2,1,"{'LD3': 1, 'LD4': 1}",2,0,"{'LD3': 1, 'LD4': 1}",
5794,7,0.039325843,1.4,2015-02-14T23:31:52Z,2015-08-11T15:36:57Z,178,173,5,0.028089888,5,6,3,4,"{'LD3': 2, 'LD4': 1}",2,4,"{'LD3': 1, 'LD4': 1}",Docs
5795,3,0.018404908,1.5,2015-02-15T15:46:13Z,2015-07-28T03:17:04Z,163,161,2,0.012269939,3,1,2,1,"{'LD1': 1, 'LD3': 1}",1,0,"{'LD1': 1, 'LD3': 1}",
5796,6,0.003466205,3,2015-02-16T16:01:28Z,2019-11-12T23:20:37Z,1731,1729,2,0.001155402,1,3,3,3,"{'LD5': 1, 'LD4': 2}",2,1,"{'LD5': 1, 'LD4': 2}",Wallet
5797,24,0.666666667,8,2015-02-17T00:27:33Z,2015-03-24T19:38:11Z,36,33,3,0.083333333,2,5,6,18,"{'LD3': 2, 'LD4': 2, 'LD1': 1, 'LD6': 1}",3,2,"{'LD3': 2, 'LD4': 2, 'LD1': 1, 'LD6': 1}",macOS
5798,4,0.002051282,1.333333333,2015-02-17T03:57:07Z,2020-06-19T21:58:19Z,1950,1947,3,0.001538462,2,3,2,2,{'LD3': 2},2,1,{'LD3': 2},"Build system,Windows"
5800,3,0.15,1,2015-02-17T21:34:08Z,2015-03-09T09:45:23Z,20,17,3,0.15,3,3,2,1,{'LD3': 2},2,1,{'LD3': 2},GUI
5802,3,0.007389163,3,2015-02-18T20:50:52Z,2016-03-30T02:56:46Z,406,405,1,0.002463054,2,2,1,2,{'LD1': 1},1,1,{'LD1': 1},Wallet
5805,3,0.013333333,1,2015-02-19T13:54:21Z,2015-10-02T01:32:40Z,225,222,3,0.013333333,2,2,1,2,{'LD5': 1},1,1,{'LD5': 1},
5806,1,0.000582072,1,2015-02-19T19:31:37Z,2019-11-02T23:14:57Z,1718,1717,1,0.000582072,2,1,1,0,{'LD3': 1},1,0,{'LD3': 1},"P2P,Tests"
5808,3,3,3,2015-02-20T12:43:17Z,2015-02-20T13:35:35Z,1,0,1,1,0,1,1,2,{'LD1': 1},1,0,{'LD1': 1},
5814,1,1,1,2015-02-21T18:18:08Z,2015-02-21T18:31:38Z,1,0,1,1,0,1,0,1,{},0,1,{},
5816,1,0.333333333,1,2015-02-23T00:11:03Z,2015-02-25T08:40:35Z,3,2,1,0.333333333,1,1,0,1,{},0,1,{},
5821,5,0.060240964,2.5,2015-02-24T14:12:48Z,2015-05-18T09:00:56Z,83,81,2,0.024096386,1,3,5,0,"{'LD4': 2, 'LD3': 3}",3,0,"{'LD4': 2, 'LD3': 2}",Bug
5822,1,0.012048193,1,2015-02-24T17:24:00Z,2015-05-18T09:03:30Z,83,82,1,0.012048193,1,1,0,1,{},0,1,{},
5827,1,0.000529942,1,2015-02-25T05:19:56Z,2020-04-26T02:00:18Z,1887,1886,1,0.000529942,1,1,0,1,{},0,1,{},Refactoring
5828,5,5,5,2015-02-25T07:42:12Z,2015-02-25T13:40:58Z,1,0,1,1,0,1,4,1,"{'LD3': 2, 'LD5': 1, 'LD4': 1}",1,0,"{'LD3': 1, 'LD5': 1, 'LD4': 1}",
5840,3,1.5,1.5,2015-02-28T09:27:09Z,2015-03-01T17:47:59Z,2,0,2,1,0,3,2,1,"{'LD1': 1, 'LD3': 1}",2,1,"{'LD1': 1, 'LD3': 1}",
5844,1,0.005882353,1,2015-03-01T20:39:04Z,2015-08-18T12:16:36Z,170,169,1,0.005882353,2,1,1,0,{'LD5': 1},1,0,{'LD5': 1},Feature
5850,2,0.25,1,2015-03-03T11:09:48Z,2015-03-10T11:56:52Z,8,6,2,0.25,1,2,0,2,{},0,2,{},UTXO Db and Indexes
5851,16,0.014532243,1.454545455,2015-03-03T11:20:52Z,2018-03-07T19:33:29Z,1101,1090,11,0.009990917,9,7,3,13,"{'LD3': 1, 'LD2': 1, 'LD6': 1}",2,5,"{'LD3': 1, 'LD2': 1, 'LD6': 1}","Bug,GUI,P2P,UTXO Db and Indexes"
5856,2,1,2,2015-03-05T18:25:58Z,2015-03-07T12:12:36Z,2,1,1,0.5,1,2,1,1,{'LD5': 1},1,1,{'LD5': 1},
5857,4,0.002115283,1,2015-03-06T07:40:52Z,2020-05-08T18:07:30Z,1891,1887,4,0.002115283,3,4,1,3,{'LD4': 1},1,3,{'LD4': 1},Brainstorming
5865,2,0.003246753,1,2015-03-07T14:11:31Z,2016-11-12T11:41:39Z,616,614,2,0.003246753,3,2,2,0,"{'LD3': 1, 'LD1': 1}",2,0,"{'LD3': 1, 'LD1': 1}","Bug,Data corruption,Windows"
5866,6,0.022641509,1.2,2015-03-07T18:03:04Z,2015-11-27T10:34:26Z,265,260,5,0.018867925,4,5,0,6,{},0,5,{},GUI
5867,1,0.25,1,2015-03-07T18:06:48Z,2015-03-11T16:37:29Z,4,3,1,0.25,1,1,0,1,{},0,1,{},GUI
5869,5,5,5,2015-03-08T09:32:21Z,2015-03-08T14:59:33Z,1,0,1,1,0,2,4,1,"{'LD1': 2, 'LD4': 2}",2,0,"{'LD1': 1, 'LD4': 2}",
5874,1,0.014285714,1,2015-03-10T03:57:03Z,2015-05-18T08:11:21Z,70,69,1,0.014285714,1,1,0,1,{},0,1,{},
5878,2,0.4,2,2015-03-11T17:16:50Z,2015-03-16T12:55:47Z,5,4,1,0.2,1,2,1,1,{'LD3': 1},1,1,{'LD3': 1},
5882,1,0.018518519,1,2015-03-12T07:49:36Z,2015-05-05T06:50:17Z,54,53,1,0.018518519,2,1,0,1,{},0,1,{},"Build system,Tests"
5886,1,0.000534759,1,2015-03-13T01:11:49Z,2020-04-24T20:11:43Z,1870,1869,1,0.000534759,2,1,1,0,{'LD4': 1},1,0,{'LD4': 1},P2P
5888,2,2,2,2015-03-13T11:56:05Z,2015-03-13T13:12:11Z,1,0,1,1,0,2,1,1,{'LD3': 1},1,1,{'LD3': 1},
5895,1,0.003802281,1,2015-03-14T09:37:33Z,2015-12-01T12:21:28Z,263,262,1,0.003802281,1,1,0,1,{},0,1,{},GUI
5897,7,0.4375,7,2015-03-14T11:08:06Z,2015-03-30T08:24:20Z,16,15,1,0.0625,1,2,5,2,"{'LD4': 3, 'LD1': 2}",2,0,"{'LD4': 2, 'LD1': 1}",
5899,2,2,2,2015-03-14T13:24:13Z,2015-03-15T03:54:42Z,1,0,1,1,0,2,1,1,{'LD1': 1},1,1,{'LD1': 1},
5902,2,0.006024096,1,2015-03-14T20:24:50Z,2016-02-09T16:07:48Z,332,330,2,0.006024096,3,2,1,1,{'LD4': 1},1,1,{'LD4': 1},Build system
5906,2,0.008298755,2,2015-03-16T05:25:21Z,2015-11-11T10:04:06Z,241,240,1,0.004149378,2,2,1,1,{'LD3': 1},1,1,{'LD3': 1},GUI
5908,11,0.045643154,2.75,2015-03-16T10:01:46Z,2015-11-11T10:02:12Z,241,237,4,0.01659751,2,3,5,6,"{'LD4': 2, 'LD3': 1, 'LD1': 1, 'LD5': 1}",2,1,"{'LD4': 2, 'LD3': 1, 'LD1': 1, 'LD5': 1}",GUI
5910,2,2,2,2015-03-16T12:10:53Z,2015-03-17T07:01:13Z,1,0,1,1,0,1,2,0,{'LD3': 2},1,0,{'LD3': 1},"Bug,Build system,GUI"
5912,1,0.5,1,2015-03-16T21:33:00Z,2015-03-18T06:45:49Z,2,1,1,0.5,1,1,0,1,{},0,1,{},
5914,1,0.043478261,1,2015-03-17T03:11:57Z,2015-04-08T07:31:19Z,23,22,1,0.043478261,2,1,0,1,{},0,1,{},
5920,1,1,1,2015-03-17T21:20:34Z,2015-03-18T07:04:22Z,1,0,1,1,0,1,1,0,{'LD4': 1},1,0,{'LD4': 1},
5921,2,0.007722008,1,2015-03-18T09:22:09Z,2015-12-01T13:41:26Z,259,257,2,0.007722008,3,2,2,0,"{'LD1': 1, 'LD5': 1}",2,0,"{'LD1': 1, 'LD5': 1}",Docs
5930,2,0.666666667,1,2015-03-21T07:09:25Z,2015-03-24T06:15:34Z,3,1,2,0.666666667,1,2,2,0,"{'LD3': 1, 'LD1': 1}",2,0,"{'LD3': 1, 'LD1': 1}",
5939,2,0.022727273,1,2015-03-22T19:53:58Z,2015-06-18T09:03:34Z,88,86,2,0.022727273,3,2,1,1,{'LD1': 1},1,1,{'LD1': 1},
5955,1,0.000539665,1,2015-03-30T18:58:14Z,2020-04-24T20:13:44Z,1853,1852,1,0.000539665,2,1,0,1,{},0,1,{},"Feature,UTXO Db and Indexes"
5956,1,0.333333333,1,2015-03-31T04:51:41Z,2015-04-02T08:15:34Z,3,2,1,0.333333333,1,1,0,1,{},0,1,{},
5974,1,0.333333333,1,2015-04-05T23:33:28Z,2015-04-08T07:21:22Z,3,2,1,0.333333333,1,1,0,1,{},0,1,{},
5977,3,0.004559271,1,2015-04-06T23:00:28Z,2017-01-23T09:00:54Z,658,655,3,0.004559271,2,3,2,1,"{'LD3': 1, 'LD5': 1}",2,1,"{'LD3': 1, 'LD5': 1}",Refactoring
5982,4,0.016949153,1,2015-04-08T04:40:08Z,2015-11-29T12:27:41Z,236,232,4,0.016949153,3,2,3,1,"{'LD3': 1, 'LD4': 1, 'LD5': 1}",2,0,"{'LD3': 1, 'LD4': 1, 'LD5': 1}",P2P
5984,2,0.006493506,1,2015-04-08T15:03:55Z,2016-02-09T16:01:40Z,308,306,2,0.006493506,2,2,0,2,{},0,2,{},Bug
5986,3,0.130434783,1.5,2015-04-08T21:15:13Z,2015-05-01T13:06:59Z,23,21,2,0.086956522,2,2,1,2,{'LD1': 1},1,1,{'LD1': 1},
6001,2,2,2,2015-04-10T20:17:12Z,2015-04-10T22:44:50Z,1,0,1,1,0,2,0,2,{},0,2,{},
6005,1,0.027777778,1,2015-04-12T09:37:02Z,2015-05-18T08:05:16Z,36,35,1,0.027777778,1,1,0,1,{},0,1,{},
6011,7,0.205882353,1.75,2015-04-14T17:33:06Z,2015-05-18T12:02:08Z,34,30,4,0.117647059,3,4,3,4,"{'LD4': 1, 'LD6': 1, 'LD3': 1}",2,2,"{'LD4': 1, 'LD6': 1, 'LD3': 1}",
6017,2,0.005221932,1,2015-04-15T17:34:46Z,2016-05-02T11:08:24Z,383,381,2,0.005221932,3,1,1,1,{'LD3': 1},1,0,{'LD3': 1},Refactoring
6018,8,8,8,2015-04-15T23:42:57Z,2015-04-16T18:05:06Z,1,0,1,1,0,3,5,3,"{'LD4': 3, 'LD6': 1, 'LD3': 1}",3,0,"{'LD4': 2, 'LD6': 1, 'LD3': 1}",
6023,2,0.001974334,2,2015-04-17T07:08:45Z,2018-01-24T01:03:26Z,1013,1012,1,0.000987167,1,2,0,2,{},0,2,{},Wallet
6027,2,1,2,2015-04-19T09:29:44Z,2015-04-20T12:07:29Z,2,1,1,0.5,1,2,0,2,{},0,2,{},
6031,1,0.034482759,1,2015-04-20T04:04:59Z,2015-05-18T08:03:14Z,29,28,1,0.034482759,2,1,1,0,{'LD4': 1},1,0,{'LD4': 1},
6040,2,2,2,2015-04-21T08:28:39Z,2015-04-21T09:41:21Z,1,0,1,1,0,2,1,1,{'LD3': 1},1,1,{'LD3': 1},Wallet
6042,2,0.074074074,2,2015-04-21T21:31:43Z,2015-05-18T08:02:19Z,27,26,1,0.037037037,1,2,0,2,{},0,2,{},
6056,2,0.333333333,2,2015-04-24T03:45:20Z,2015-04-29T07:04:10Z,6,5,1,0.166666667,2,2,2,0,"{'LD4': 1, 'LD3': 1}",2,0,"{'LD4': 1, 'LD3': 1}",
6067,3,0.15,1,2015-04-26T14:29:54Z,2015-05-15T17:04:20Z,20,17,3,0.15,2,2,2,1,"{'LD4': 1, 'LD3': 1}",1,1,"{'LD4': 1, 'LD3': 1}",
6069,5,0.002718869,2.5,2015-04-26T21:37:58Z,2020-05-08T18:11:08Z,1839,1837,2,0.001087548,2,3,0,5,{},0,3,{},GUI
6070,2,0.105263158,2,2015-04-27T00:35:45Z,2015-05-15T17:02:20Z,19,18,1,0.052631579,2,1,1,1,{'LD3': 1},1,0,{'LD3': 1},
6078,11,0.916666667,2.75,2015-04-28T18:22:23Z,2015-05-10T12:23:05Z,12,8,4,0.333333333,1,5,4,7,"{'LD4': 2, 'LD3': 1, 'LD1': 1}",2,3,"{'LD4': 2, 'LD3': 1, 'LD1': 1}","Bug,Windows"
6084,4,0.003831418,1.333333333,2015-04-29T14:54:31Z,2018-03-08T03:46:36Z,1044,1041,3,0.002873563,4,2,1,3,{'LD4': 1},1,1,{'LD4': 1},"Bug,Wallet"
6087,3,3,3,2015-04-30T20:24:33Z,2015-05-01T12:12:15Z,1,0,1,1,0,3,1,2,{'LD1': 1},1,2,{'LD1': 1},
6090,5,5,5,2015-05-01T00:57:07Z,2015-05-01T11:26:30Z,1,0,1,1,0,1,3,2,"{'LD4': 1, 'LD5': 2}",1,0,"{'LD4': 1, 'LD5': 1}",
6091,2,0.007017544,2,2015-05-01T05:30:04Z,2016-02-09T16:00:32Z,285,284,1,0.003508772,2,2,0,2,{},0,2,{},Bug
6095,11,0.010566763,2.2,2015-05-02T03:03:55Z,2018-03-07T23:32:51Z,1041,1036,5,0.004803074,4,4,7,4,"{'LD4': 3, 'LD3': 3, 'LD1': 1}",4,0,"{'LD4': 3, 'LD3': 2, 'LD1': 1}","Bug,Wallet"
6100,1,1,1,2015-05-03T11:24:24Z,2015-05-03T11:35:22Z,1,0,1,1,0,1,1,0,{'LD3': 1},1,0,{'LD3': 1},
6106,1,0.090909091,1,2015-05-05T01:31:05Z,2015-05-15T16:56:50Z,11,10,1,0.090909091,2,1,0,1,{},0,1,{},
6113,4,1,4,2015-05-06T16:27:32Z,2015-05-10T12:29:01Z,4,3,1,0.25,1,1,2,2,"{'LD3': 1, 'LD1': 1}",1,0,"{'LD3': 1, 'LD1': 1}",
6115,1,1,1,2015-05-07T07:08:06Z,2015-05-07T16:02:03Z,1,0,1,1,0,1,0,1,{},0,1,{},
6119,4,0.5,1.333333333,2015-05-08T20:28:32Z,2015-05-16T00:02:03Z,8,5,3,0.375,2,2,2,2,"{'LD6': 1, 'LD4': 1}",1,1,"{'LD6': 1, 'LD4': 1}",Tests
6120,2,2,2,2015-05-09T20:20:04Z,2015-05-10T12:30:31Z,1,0,1,1,0,2,1,1,{'LD3': 1},1,1,{'LD3': 1},
6139,1,1,1,2015-05-14T16:05:40Z,2015-05-15T11:16:08Z,1,0,1,1,0,1,0,1,{},0,1,{},
6142,1,0.004672897,1,2015-05-15T03:02:18Z,2015-12-14T12:08:43Z,214,213,1,0.004672897,2,1,1,0,{'LD3': 1},1,0,{'LD3': 1},Docs
6157,2,2,2,2015-05-19T00:32:40Z,2015-05-19T07:38:01Z,1,0,1,1,0,2,0,2,{},0,2,{},
6167,1,1,1,2015-05-20T21:17:47Z,2015-05-21T10:24:57Z,1,0,1,1,0,1,1,0,{'LD5': 1},1,0,{'LD5': 1},
6170,3,3,3,2015-05-21T08:56:11Z,2015-05-21T10:23:17Z,1,0,1,1,0,1,0,3,{},0,1,{},
6175,8,4,8,2015-05-22T14:26:29Z,2015-05-24T08:38:51Z,2,1,1,0.5,1,3,3,5,{'LD1': 3},1,2,{'LD1': 1},
6182,1,0.333333333,1,2015-05-24T02:59:26Z,2015-05-26T05:55:15Z,3,2,1,0.333333333,1,1,1,0,{'LD1': 1},1,0,{'LD1': 1},
6184,13,0.590909091,3.25,2015-05-25T17:25:58Z,2015-06-16T12:55:46Z,22,18,4,0.181818182,3,4,6,7,"{'LD4': 2, 'LD1': 2, 'LD3': 2}",2,2,"{'LD4': 1, 'LD1': 1, 'LD3': 1}",Bug
6188,6,0.857142857,2,2015-05-26T09:59:15Z,2015-06-02T06:39:00Z,7,4,3,0.428571429,1,2,3,3,"{'LD4': 2, 'LD1': 1}",2,0,"{'LD4': 2, 'LD1': 1}",P2P
6192,8,1.333333333,4,2015-05-27T05:43:11Z,2015-06-01T11:13:11Z,6,4,2,0.333333333,2,4,4,4,"{'LD6': 1, 'LD3': 1, 'LD4': 1, 'LD1': 1}",2,2,"{'LD6': 1, 'LD3': 1, 'LD4': 1, 'LD1': 1}",
6196,3,0.15,1,2015-05-27T20:31:14Z,2015-06-16T13:21:48Z,20,17,3,0.15,3,3,3,0,"{'LD3': 1, 'LD1': 2}",3,0,"{'LD3': 1, 'LD1': 2}","Bug,Windows"
6200,3,0.75,1,2015-05-28T21:39:27Z,2015-06-01T11:11:03Z,4,1,3,0.75,1,2,2,1,{'LD4': 2},2,0,{'LD4': 2},Windows
6211,31,0.093093093,3.1,2015-06-01T11:04:27Z,2016-04-28T11:18:47Z,333,323,10,0.03003003,6,12,9,22,"{'LD6': 3, 'LD3': 2, 'LD4': 4}",4,8,"{'LD6': 3, 'LD3': 2, 'LD4': 2}","Build system,Refactoring"
6223,7,7,7,2015-06-03T00:10:39Z,2015-06-03T13:13:46Z,1,0,1,1,0,3,0,7,{},0,3,{},Bug
6251,10,0.008857396,1.428571429,2015-06-08T04:57:13Z,2018-07-10T11:52:30Z,1129,1122,7,0.006200177,5,7,5,5,"{'LD3': 3, 'LD2': 1, 'LD4': 1}",4,3,"{'LD3': 3, 'LD2': 1, 'LD4': 1}",P2P
6252,2,0.285714286,2,2015-06-08T09:47:44Z,2015-06-15T08:32:29Z,7,6,1,0.142857143,2,2,1,1,{'LD4': 1},1,1,{'LD4': 1},Build system
6253,1,0.5,1,2015-06-08T10:33:59Z,2015-06-09T11:48:46Z,2,1,1,0.5,1,1,0,1,{},0,1,{},
6263,2,2,2,2015-06-09T21:28:43Z,2015-06-10T13:26:09Z,1,0,1,1,0,2,2,0,"{'LD1': 1, 'LD3': 1}",2,0,"{'LD1': 1, 'LD3': 1}",Data corruption
6267,7,0.538461538,1.75,2015-06-10T15:19:43Z,2015-06-22T19:16:02Z,13,9,4,0.307692308,3,5,1,6,{'LD3': 1},1,4,{'LD3': 1},GUI
6268,7,0.170731707,1.75,2015-06-10T19:15:06Z,2015-07-21T10:48:09Z,41,37,4,0.097560976,3,5,1,6,{'LD2': 1},1,4,{'LD2': 1},"RPC/REST/ZMQ,Tests"
6270,3,0.1,1.5,2015-06-11T00:27:38Z,2015-07-10T12:55:06Z,30,28,2,0.066666667,2,3,1,2,{'LD1': 1},1,2,{'LD1': 1},Mining
6273,2,2,2,2015-06-12T10:00:15Z,2015-06-12T14:58:24Z,1,0,1,1,0,1,0,2,{},0,1,{},GUI
6275,2,0.4,1,2015-06-12T12:25:47Z,2015-06-16T12:51:23Z,5,3,2,0.4,2,1,1,1,{'LD1': 1},1,0,{'LD1': 1},
6289,1,1,1,2015-06-16T10:52:20Z,2015-06-16T13:29:04Z,1,0,1,1,0,1,0,1,{},0,1,{},
6293,3,0.003015075,1.5,2015-06-16T19:59:57Z,2018-03-07T18:07:42Z,995,993,2,0.00201005,2,2,0,3,{},0,2,{},P2P
6295,1,0.041666667,1,2015-06-16T21:15:11Z,2015-07-09T23:30:00Z,24,23,1,0.041666667,1,1,1,0,{'LD1': 1},1,0,{'LD1': 1},
6297,2,0.008403361,1,2015-06-17T15:26:26Z,2016-02-09T16:06:14Z,238,236,2,0.008403361,2,2,0,2,{},0,2,{},"Bug,RPC/REST/ZMQ"
6304,8,0.008056395,2,2015-06-19T02:20:53Z,2018-03-07T18:15:57Z,993,989,4,0.004028197,3,4,2,6,"{'LD6': 1, 'LD4': 1}",2,2,"{'LD6': 1, 'LD4': 1}","Brainstorming,Privacy"
6320,2,0.008583691,2,2015-06-22T11:43:58Z,2016-02-10T11:32:35Z,233,232,1,0.004291845,1,2,0,2,{},0,2,{},Tests
6321,6,3,6,2015-06-22T20:20:55Z,2015-06-23T23:30:42Z,2,1,1,0.5,1,4,2,4,"{'LD5': 1, 'LD3': 1}",2,2,"{'LD5': 1, 'LD3': 1}",
6325,3,3,3,2015-06-23T14:23:26Z,2015-06-23T18:01:59Z,1,0,1,1,0,2,1,2,{'LD4': 1},1,1,{'LD4': 1},
6326,9,0.529411765,9,2015-06-23T15:25:11Z,2015-07-09T23:22:39Z,17,16,1,0.058823529,1,5,2,7,"{'LD4': 1, 'LD3': 1}",1,4,"{'LD4': 1, 'LD3': 1}",
6330,3,0.023809524,1.5,2015-06-24T06:53:52Z,2015-10-27T10:49:27Z,126,124,2,0.015873016,2,3,1,2,{'LD3': 1},1,2,{'LD3': 1},
6332,1,0.076923077,1,2015-06-24T09:11:57Z,2015-07-07T02:28:11Z,13,12,1,0.076923077,2,1,1,0,{'LD4': 1},1,0,{'LD4': 1},
6338,2,0.1,1,2015-06-24T19:47:53Z,2015-07-14T00:35:57Z,20,18,2,0.1,2,2,1,1,{'LD3': 1},1,1,{'LD3': 1},Wallet
6340,5,0.044642857,1.666666667,2015-06-26T03:35:34Z,2015-10-15T10:54:21Z,112,109,3,0.026785714,3,5,4,1,"{'LD4': 2, 'LD5': 2}",4,1,"{'LD4': 2, 'LD5': 2}",Docs
6345,1,0.026315789,1,2015-06-27T08:17:56Z,2015-08-03T17:34:58Z,38,37,1,0.026315789,2,1,0,1,{},0,1,{},Wallet
6348,1,0.5,1,2015-06-28T01:41:01Z,2015-06-29T12:53:56Z,2,1,1,0.5,1,1,1,0,{'LD4': 1},1,0,{'LD4': 1},
6358,3,0.3,1.5,2015-06-30T20:31:01Z,2015-07-09T23:15:04Z,10,8,2,0.2,1,2,2,1,"{'LD4': 1, 'LD2': 1}",2,0,"{'LD4': 1, 'LD2': 1}",Validation
6360,1,1,1,2015-07-01T10:08:53Z,2015-07-01T11:15:14Z,1,0,1,1,0,1,0,1,{},0,1,{},
6367,4,4,4,2015-07-03T00:21:57Z,2015-07-03T07:39:35Z,1,0,1,1,0,3,0,4,{},0,3,{},
6375,1,0.00862069,1,2015-07-04T03:09:09Z,2015-10-27T10:49:59Z,116,115,1,0.00862069,2,1,1,0,{'LD3': 1},1,0,{'LD3': 1},P2P
6376,4,0.004048583,1,2015-07-04T04:25:39Z,2018-03-17T14:01:34Z,988,984,4,0.004048583,2,3,2,2,"{'LD3': 1, 'LD5': 1}",2,1,"{'LD3': 1, 'LD5': 1}",Consensus
6386,4,0.019512195,4,2015-07-07T07:50:34Z,2016-01-27T16:20:53Z,205,204,1,0.004878049,1,1,4,0,"{'LD4': 2, 'LD6': 1, 'LD3': 1}",1,0,"{'LD4': 1, 'LD6': 1, 'LD3': 1}","Linux/Unix,UTXO Db and Indexes"
6389,4,1.333333333,4,2015-07-07T15:04:31Z,2015-07-10T12:52:28Z,3,2,1,0.333333333,1,2,0,4,{},0,2,{},Tests
6391,5,0.833333333,1.25,2015-07-07T16:37:00Z,2015-07-13T06:27:47Z,6,2,4,0.666666667,1,3,4,1,"{'LD3': 2, 'LD4': 1, 'LD6': 1}",2,1,"{'LD3': 2, 'LD4': 1, 'LD6': 1}",Tests
6392,2,2,2,2015-07-07T19:41:23Z,2015-07-07T21:32:03Z,1,0,1,1,0,1,0,2,{},0,1,{},
6393,3,0.013824885,1,2015-07-07T20:59:25Z,2016-02-09T15:59:57Z,217,214,3,0.013824885,3,3,0,3,{},0,3,{},
6394,1,0.023255814,1,2015-07-07T21:09:39Z,2015-08-19T14:27:41Z,43,42,1,0.023255814,1,1,0,1,{},0,1,{},Bug
6399,1,0.055555556,1,2015-07-08T18:20:09Z,2015-07-26T10:46:29Z,18,17,1,0.055555556,1,1,1,0,{'LD1': 1},1,0,{'LD1': 1},
6404,1,1,1,2015-07-09T04:39:44Z,2015-07-09T23:03:45Z,1,0,1,1,0,1,0,1,{},0,1,{},
6406,3,0.6,3,2015-07-09T07:20:12Z,2015-07-13T11:51:47Z,5,4,1,0.2,2,2,0,3,{},0,2,{},Build system
6411,2,0.181818182,2,2015-07-09T21:40:51Z,2015-07-20T14:54:37Z,11,10,1,0.090909091,1,2,1,1,{'LD6': 1},1,1,{'LD6': 1},
6425,3,0.02970297,3,2015-07-12T20:12:34Z,2015-10-21T09:19:53Z,101,100,1,0.00990099,1,3,1,2,{'LD3': 1},1,2,{'LD3': 1},RPC/REST/ZMQ
6426,8,0.533333333,2.666666667,2015-07-12T22:56:57Z,2015-07-27T11:22:10Z,15,12,3,0.2,3,5,3,5,{'LD3': 3},2,3,{'LD3': 2},"Bug,GUI"
6427,4,0.013745704,1.333333333,2015-07-13T00:17:24Z,2016-04-28T12:59:07Z,291,288,3,0.010309278,3,4,2,2,{'LD4': 2},2,2,{'LD4': 2},"Bug,RPC/REST/ZMQ"
6429,6,0.013186813,1.2,2015-07-13T15:48:22Z,2016-10-10T09:33:47Z,455,450,5,0.010989011,6,4,4,2,"{'LD1': 3, 'LD4': 1}",3,1,"{'LD1': 3, 'LD4': 1}",Windows
6431,4,0.004132231,2,2015-07-14T07:42:02Z,2018-03-07T18:07:01Z,968,966,2,0.002066116,3,3,1,3,{'LD1': 1},1,2,{'LD1': 1},GUI
6432,18,0.021077283,1.636363636,2015-07-14T07:49:09Z,2017-11-13T12:01:48Z,854,843,11,0.012880562,10,9,11,7,"{'LD1': 1, 'LD3': 6, 'LD4': 2, 'LD5': 1, 'LD2': 1}",7,2,"{'LD1': 1, 'LD3': 5, 'LD4': 2, 'LD5': 1, 'LD2': 1}",Build system
6436,1,1,1,2015-07-14T20:19:35Z,2015-07-15T13:49:58Z,1,0,1,1,0,1,0,1,{},0,1,{},Bug
6437,1,0.001034126,1,2015-07-14T21:47:19Z,2018-03-07T17:57:07Z,967,966,1,0.001034126,1,1,1,0,{'LD3': 1},1,0,{'LD3': 1},GUI
6441,1,0.166666667,1,2015-07-15T14:36:27Z,2015-07-20T15:57:49Z,6,5,1,0.166666667,1,1,1,0,{'LD6': 1},1,0,{'LD6': 1},"Build system,Consensus"
6443,4,0.444444444,2,2015-07-15T19:58:26Z,2015-07-24T09:09:00Z,9,7,2,0.222222222,2,1,2,2,"{'LD1': 1, 'LD3': 1}",1,0,"{'LD1': 1, 'LD3': 1}","GUI,RPC/REST/ZMQ"
6454,8,0.163265306,2,2015-07-17T19:38:25Z,2015-09-04T15:26:07Z,49,45,4,0.081632653,3,4,5,3,"{'LD3': 3, 'LD1': 1, 'LD5': 1}",3,1,"{'LD3': 3, 'LD1': 1, 'LD5': 1}",RPC/REST/ZMQ
6458,2,0.007017544,1,2015-07-18T17:24:20Z,2016-04-28T11:16:56Z,285,283,2,0.007017544,3,2,2,0,"{'LD2': 1, 'LD3': 1}",2,0,"{'LD2': 1, 'LD3': 1}","Build system,Windows"
6459,3,0.014563107,1,2015-07-18T19:33:54Z,2016-02-09T16:05:09Z,206,203,3,0.014563107,2,2,1,2,{'LD5': 1},1,1,{'LD5': 1},Validation
6460,7,2.333333333,3.5,2015-07-19T13:54:57Z,2015-07-21T19:40:33Z,3,1,2,0.666666667,1,5,2,5,"{'LD3': 1, 'LD1': 1}",1,4,"{'LD3': 1, 'LD1': 1}",GUI
6461,17,0.016098485,2.125,2015-07-21T19:40:13Z,2018-06-11T12:22:20Z,1056,1048,8,0.007575758,6,7,7,10,"{'LD3': 3, 'LD4': 1, 'LD1': 1, 'LD2': 1, 'LD6': 1}",5,2,"{'LD3': 3, 'LD4': 1, 'LD1': 1, 'LD2': 1, 'LD6': 1}","Feature,GUI"
6463,11,0.006811146,1.571428571,2015-07-22T13:40:50Z,2019-12-22T15:13:45Z,1615,1608,7,0.004334365,5,4,5,6,"{'LD4': 3, 'LD3': 2}",2,2,"{'LD4': 2, 'LD3': 1}","Build system,Upstream,macOS"
6466,6,0.003778338,2,2015-07-22T16:45:57Z,2019-11-25T19:59:57Z,1588,1585,3,0.001889169,3,5,5,1,"{'LD3': 4, 'LD2': 1}",4,1,"{'LD3': 3, 'LD2': 1}","Hacktoberfest,Tests,good first issue"
6472,8,0.023880597,2,2015-07-24T10:19:20Z,2016-06-22T11:47:59Z,335,331,4,0.011940299,2,5,4,4,"{'LD4': 2, 'LD2': 1, 'LD3': 1}",4,1,"{'LD4': 2, 'LD2': 1, 'LD3': 1}","GUI,Upstream"
6474,1,0.5,1,2015-07-25T08:31:35Z,2015-07-27T05:26:45Z,2,1,1,0.5,1,1,1,0,{'LD2': 1},1,0,{'LD2': 1},
6478,1,1,1,2015-07-26T15:57:37Z,2015-07-27T05:19:34Z,1,0,1,1,0,1,1,0,{'LD1': 1},1,0,{'LD1': 1},
6483,2,1,1,2015-07-28T01:48:00Z,2015-07-29T12:21:53Z,2,0,2,1,0,2,1,1,{'LD4': 1},1,1,{'LD4': 1},RPC/REST/ZMQ
6486,5,0.043478261,1.666666667,2015-07-28T12:08:48Z,2015-11-20T09:24:59Z,115,112,3,0.026086957,3,3,4,1,"{'LD3': 1, 'LD4': 1, 'LD2': 1, 'LD5': 1}",3,0,"{'LD3': 1, 'LD4': 1, 'LD2': 1, 'LD5': 1}",Build system
6490,6,0.157894737,3,2015-07-29T09:36:53Z,2015-09-04T16:01:49Z,38,36,2,0.052631579,2,4,0,6,{},0,4,{},
6491,4,0.444444444,2,2015-07-29T14:21:01Z,2015-08-07T11:11:19Z,9,7,2,0.222222222,2,3,1,3,{'LD3': 1},1,2,{'LD3': 1},"Build system,Linux/Unix"
6493,1,0.000921659,1,2015-07-30T15:04:27Z,2018-07-18T22:47:16Z,1085,1084,1,0.000921659,2,1,0,1,{},0,1,{},"Build system,GUI"
6495,3,0.001731102,3,2015-07-30T21:00:43Z,2020-04-27T00:27:15Z,1733,1732,1,0.000577034,1,3,1,2,{'LD5': 1},1,2,{'LD5': 1},"Block storage,Windows"
6496,1,0.004975124,1,2015-07-31T11:29:15Z,2016-02-16T15:15:00Z,201,200,1,0.004975124,2,1,1,0,{'LD1': 1},1,0,{'LD1': 1},Data corruption
6500,1,0.05,1,2015-07-31T19:21:57Z,2015-08-20T15:36:37Z,20,19,1,0.05,2,1,1,0,{'LD5': 1},1,0,{'LD5': 1},
6502,6,0.113207547,2,2015-08-01T05:00:25Z,2015-09-22T20:16:26Z,53,50,3,0.056603774,4,3,1,5,{'LD3': 1},1,2,{'LD3': 1},
6506,2,2,2,2015-08-03T10:30:49Z,2015-08-03T18:56:21Z,1,0,1,1,0,2,0,2,{},0,2,{},Bug
6513,2,2,2,2015-08-04T06:53:26Z,2015-08-04T07:31:14Z,1,0,1,1,0,1,1,1,{'LD4': 1},1,0,{'LD4': 1},
6514,3,0.038461538,1.5,2015-08-04T08:20:35Z,2015-10-20T09:26:53Z,78,76,2,0.025641026,1,3,0,3,{},0,3,{},Wallet
6515,4,0.571428571,2,2015-08-04T14:10:54Z,2015-08-10T15:38:29Z,7,5,2,0.285714286,1,3,1,3,{'LD3': 1},1,2,{'LD3': 1},Build system
6516,2,2,2,2015-08-04T15:35:26Z,2015-08-05T10:53:31Z,1,0,1,1,0,2,0,2,{},0,2,{},Wallet
6518,5,0.102040816,1,2015-08-05T02:50:10Z,2015-09-22T20:21:06Z,49,44,5,0.102040816,3,4,4,1,"{'LD1': 1, 'LD3': 2, 'LD4': 1}",4,0,"{'LD1': 1, 'LD3': 2, 'LD4': 1}",Windows
6522,2,0.01025641,1,2015-08-05T18:53:38Z,2016-02-16T16:58:43Z,195,193,2,0.01025641,3,1,2,0,"{'LD1': 1, 'LD2': 1}",1,0,"{'LD1': 1, 'LD2': 1}",Wallet
6525,3,3,3,2015-08-06T01:23:19Z,2015-08-06T02:08:34Z,1,0,1,1,0,1,0,3,{},0,1,{},
6528,39,0.049118388,1.772727273,2015-08-06T08:03:16Z,2017-10-07T11:36:09Z,794,772,22,0.027707809,19,23,17,22,"{'LD3': 13, 'LD4': 2, 'LD1': 2}",13,10,"{'LD3': 12, 'LD4': 2, 'LD1': 1}","Data corruption,UTXO Db and Indexes"
6531,8,0.017817372,1.6,2015-08-07T00:17:43Z,2016-10-28T21:14:38Z,449,444,5,0.011135857,4,3,2,6,{'LD3': 2},2,1,{'LD3': 2},Mining
6535,1,0.035714286,1,2015-08-08T08:46:18Z,2015-09-04T16:05:02Z,28,27,1,0.035714286,1,1,1,0,{'LD1': 1},1,0,{'LD1': 1},macOS
6536,2,0.042553191,2,2015-08-08T13:25:17Z,2015-09-23T17:38:08Z,47,46,1,0.021276596,2,2,1,1,{'LD3': 1},1,1,{'LD3': 1},Wallet
6540,21,0.076642336,2.333333333,2015-08-10T17:20:59Z,2016-05-10T10:08:28Z,274,265,9,0.032846715,6,7,6,15,"{'LD4': 2, 'LD1': 2, 'LD3': 2}",4,3,"{'LD4': 1, 'LD1': 2, 'LD3': 1}",Tests
6542,10,0.476190476,3.333333333,2015-08-10T19:52:46Z,2015-08-31T12:49:05Z,21,18,3,0.142857143,3,7,7,3,"{'LD1': 1, 'LD2': 1, 'LD4': 2, 'LD3': 2, 'LD5': 1}",5,2,"{'LD1': 1, 'LD2': 1, 'LD4': 2, 'LD3': 2, 'LD5': 1}",
6549,3,0.038961039,3,2015-08-11T18:18:08Z,2015-10-27T10:47:43Z,77,76,1,0.012987013,1,2,0,3,{},0,2,{},"Build system,Windows"
6552,11,1.833333333,5.5,2015-08-13T08:50:34Z,2015-08-18T09:35:49Z,6,4,2,0.333333333,1,7,3,8,"{'LD6': 2, 'LD3': 1}",3,4,"{'LD6': 2, 'LD3': 1}",
6554,11,0.011305242,1.833333333,2015-08-13T14:26:20Z,2018-04-11T19:58:19Z,973,967,6,0.006166495,6,7,4,7,"{'LD3': 1, 'LD1': 1, 'LD4': 1, 'LD5': 1}",4,3,"{'LD3': 1, 'LD1': 1, 'LD4': 1, 'LD5': 1}","Tests,Windows"
6555,1,0.047619048,1,2015-08-14T15:59:27Z,2015-09-04T14:31:55Z,21,20,1,0.047619048,1,1,0,1,{},0,1,{},
6558,11,1.222222222,2.2,2015-08-15T12:36:25Z,2015-08-24T11:44:03Z,9,4,5,0.555555556,2,5,3,8,"{'LD1': 1, 'LD6': 2}",1,4,"{'LD1': 1, 'LD6': 1}",
6559,2,0.133333333,1,2015-08-16T11:49:19Z,2015-08-30T19:18:08Z,15,13,2,0.133333333,1,2,1,1,{'LD5': 1},1,1,{'LD5': 1},
6560,3,0.007125891,1,2015-08-17T00:50:03Z,2016-10-10T02:06:53Z,421,418,3,0.007125891,2,2,1,2,{'LD3': 1},1,1,{'LD3': 1},Refactoring
6562,1,1,1,2015-08-17T17:12:42Z,2015-08-17T23:52:24Z,1,0,1,1,0,1,0,1,{},0,1,{},
6573,3,0.00173913,1,2015-08-19T10:38:37Z,2020-05-08T18:12:00Z,1725,1722,3,0.00173913,1,3,2,1,"{'LD1': 1, 'LD4': 1}",2,1,"{'LD1': 1, 'LD4': 1}","Resource usage,Wallet"
6574,6,0.006369427,1.2,2015-08-19T17:46:51Z,2018-03-17T18:10:37Z,942,937,5,0.005307856,1,5,2,4,"{'LD4': 1, 'LD2': 1}",2,3,"{'LD4': 1, 'LD2': 1}","Brainstorming,Mining"
6578,9,9,9,2015-08-20T23:30:57Z,2015-08-21T04:57:26Z,1,0,1,1,0,3,1,8,{'LD2': 1},1,2,{'LD2': 1},
6582,3,0.032258065,1.5,2015-08-23T16:18:21Z,2015-11-24T09:21:28Z,93,91,2,0.021505376,2,1,0,3,{},0,1,{},"Bug,Wallet"
6585,1,1,1,2015-08-24T08:21:55Z,2015-08-24T10:38:01Z,1,0,1,1,0,1,1,0,{'LD1': 1},1,0,{'LD1': 1},"P2P,Privacy"
6586,4,0.047058824,1.333333333,2015-08-24T09:59:58Z,2015-11-16T15:23:10Z,85,82,3,0.035294118,3,2,2,2,"{'LD4': 1, 'LD1': 1}",2,0,"{'LD4': 1, 'LD1': 1}","P2P,Privacy"
6593,3,0.375,1.5,2015-08-27T17:07:36Z,2015-09-04T15:53:02Z,8,6,2,0.25,2,1,1,2,{'LD4': 1},1,0,{'LD4': 1},
6598,2,0.024390244,2,2015-08-29T09:35:35Z,2015-11-18T13:15:49Z,82,81,1,0.012195122,1,1,0,2,{},0,1,{},RPC/REST/ZMQ
6601,5,0.003032141,1.25,2015-08-31T00:29:37Z,2020-03-05T07:09:30Z,1649,1645,4,0.002425713,4,4,1,4,{'LD3': 1},1,3,{'LD3': 1},GUI
6602,3,0.130434783,1.5,2015-08-31T03:45:17Z,2015-09-22T20:13:11Z,23,21,2,0.086956522,2,1,1,2,{'LD1': 1},1,0,{'LD1': 1},
6603,4,0.571428571,2,2015-08-31T06:05:24Z,2015-09-06T09:39:53Z,7,5,2,0.285714286,2,3,3,1,"{'LD1': 1, 'LD3': 2}",2,1,"{'LD1': 1, 'LD3': 2}",Linux/Unix
6605,5,0.005307856,1.666666667,2015-08-31T11:37:41Z,2018-03-29T14:50:19Z,942,939,3,0.003184713,2,5,1,4,{'LD3': 1},1,4,{'LD3': 1},RPC/REST/ZMQ
6606,3,1.5,3,2015-08-31T12:23:10Z,2015-09-02T04:30:55Z,2,1,1,0.5,1,2,2,1,"{'LD1': 1, 'LD4': 1}",2,0,"{'LD1': 1, 'LD4': 1}","Data corruption,Windows"
6613,33,0.916666667,8.25,2015-09-01T14:03:54Z,2015-10-06T15:51:04Z,36,32,4,0.111111111,2,7,12,21,"{'LD4': 4, 'LD3': 6, 'LD1': 2}",6,1,"{'LD4': 3, 'LD3': 4, 'LD1': 2}","UTXO Db and Indexes,Windows"
6614,1,0.014084507,1,2015-09-01T20:55:33Z,2015-11-11T13:19:37Z,71,70,1,0.014084507,1,1,1,0,{'LD4': 1},1,0,{'LD4': 1},GUI
6615,2,0.027027027,1,2015-09-01T20:55:51Z,2015-11-14T19:06:44Z,74,72,2,0.027027027,2,1,2,0,{'LD4': 2},1,0,{'LD4': 1},GUI
6623,2,1,1,2015-09-02T21:01:52Z,2015-09-04T17:30:27Z,2,0,2,1,0,1,0,2,{},0,1,{},RPC/REST/ZMQ
6624,1,0.05,1,2015-09-02T21:18:31Z,2015-09-22T17:55:40Z,20,19,1,0.05,2,1,0,1,{},0,1,{},Build system
6632,2,0.1,2,2015-09-03T18:23:18Z,2015-09-22T20:11:36Z,20,19,1,0.05,1,2,1,1,{'LD2': 1},1,1,{'LD2': 1},
6651,4,0.010025063,1.333333333,2015-09-08T00:11:39Z,2016-10-10T08:34:20Z,399,396,3,0.007518797,4,3,0,4,{},0,3,{},RPC/REST/ZMQ
6655,8,0.195121951,1.6,2015-09-09T21:35:24Z,2015-10-20T13:40:06Z,41,36,5,0.12195122,4,6,4,4,"{'LD4': 1, 'LD1': 2, 'LD2': 1}",3,3,"{'LD4': 1, 'LD1': 2, 'LD2': 1}",P2P
6658,45,0.030140656,2.368421053,2015-09-10T22:43:19Z,2019-10-12T13:27:52Z,1493,1474,19,0.012726055,16,15,6,39,"{'LD3': 1, 'LD2': 1, 'LD4': 3, 'LD1': 1}",3,12,"{'LD3': 1, 'LD2': 1, 'LD4': 2, 'LD1': 1}","Build system,Resource usage"
6660,1,0.090909091,1,2015-09-11T09:04:40Z,2015-09-21T15:16:58Z,11,10,1,0.090909091,1,1,1,0,{'LD3': 1},1,0,{'LD3': 1},
6665,2,0.052631579,1,2015-09-12T17:24:57Z,2015-10-20T13:35:09Z,38,36,2,0.052631579,2,2,2,0,"{'LD3': 1, 'LD1': 1}",2,0,"{'LD3': 1, 'LD1': 1}",Windows
6670,7,0.159090909,2.333333333,2015-09-14T07:40:53Z,2015-10-27T10:32:26Z,44,41,3,0.068181818,2,3,4,3,"{'LD4': 2, 'LD3': 2}",2,1,"{'LD4': 2, 'LD3': 2}",macOS
6675,5,0.009259259,2.5,2015-09-15T05:12:26Z,2017-03-07T18:31:49Z,540,538,2,0.003703704,3,4,0,5,{},0,4,{},"Mempool,Mining,TX fees and policy"
6676,1,0.027777778,1,2015-09-15T10:59:42Z,2015-10-21T10:20:48Z,36,35,1,0.027777778,2,1,0,1,{},0,1,{},P2P
6677,8,4,8,2015-09-16T05:14:00Z,2015-09-18T00:16:00Z,2,1,1,0.5,1,5,4,4,"{'LD4': 3, 'LD3': 1}",3,2,"{'LD4': 3, 'LD3': 1}",
6682,1,1,1,2015-09-16T14:57:33Z,2015-09-17T13:46:09Z,1,0,1,1,0,1,1,0,{'LD3': 1},1,0,{'LD3': 1},
6683,4,0.666666667,2,2015-09-16T18:53:30Z,2015-09-22T08:52:42Z,6,4,2,0.333333333,2,2,2,2,"{'LD6': 1, 'LD2': 1}",2,0,"{'LD6': 1, 'LD2': 1}",GUI
6691,1,0.000890472,1,2015-09-18T03:28:56Z,2018-10-14T09:55:59Z,1123,1122,1,0.000890472,2,1,1,0,{'LD2': 1},1,0,{'LD2': 1},Bug
6697,1,0.25,1,2015-09-19T00:50:24Z,2015-09-22T20:01:33Z,4,3,1,0.25,1,1,0,1,{},0,1,{},
6698,1,0.25,1,2015-09-19T09:10:22Z,2015-09-22T17:48:12Z,4,3,1,0.25,1,1,0,1,{},0,1,{},
6699,9,0.147540984,2.25,2015-09-19T10:13:04Z,2015-11-18T14:48:21Z,61,57,4,0.06557377,4,5,5,4,"{'LD1': 2, 'LD5': 1, 'LD4': 1, 'LD3': 1}",4,1,"{'LD1': 2, 'LD5': 1, 'LD4': 1, 'LD3': 1}",Build system
6701,1,0.003610108,1,2015-09-20T03:05:51Z,2016-06-22T08:04:19Z,277,276,1,0.003610108,1,1,0,1,{},0,1,{},Bug
6702,2,0.007220217,1,2015-09-20T03:06:20Z,2016-06-22T10:43:40Z,277,275,2,0.007220217,3,1,0,2,{},0,1,{},Bug
6714,7,0.004146919,1.4,2015-09-23T17:23:09Z,2020-05-07T00:12:18Z,1688,1683,5,0.002962085,3,4,1,6,{'LD1': 1},1,3,{'LD1': 1},"Brainstorming,Refactoring"
6716,1,1,1,2015-09-24T06:38:08Z,2015-09-24T06:47:34Z,1,0,1,1,0,1,0,1,{},0,1,{},
6725,7,0.041176471,1.75,2015-09-26T09:16:19Z,2016-03-14T00:35:20Z,170,166,4,0.023529412,2,4,4,3,"{'LD4': 2, 'LD3': 2}",2,2,"{'LD4': 2, 'LD3': 1}","Mempool,TX fees and policy,Wallet"
6727,3,0.6,1.5,2015-09-27T14:36:16Z,2015-10-02T06:11:25Z,5,3,2,0.4,2,2,2,1,"{'LD4': 1, 'LD2': 1}",2,0,"{'LD4': 1, 'LD2': 1}",
6734,4,2,2,2015-09-28T17:12:02Z,2015-09-29T23:11:29Z,2,0,2,1,0,3,1,3,{'LD3': 1},1,2,{'LD3': 1},"Build system,Docs"
6738,2,2,2,2015-09-30T02:26:24Z,2015-09-30T08:48:02Z,1,0,1,1,0,1,1,1,{'LD1': 1},1,0,{'LD1': 1},
6746,1,1,1,2015-10-02T04:54:23Z,2015-10-02T16:57:14Z,1,0,1,1,0,1,0,1,{},0,1,{},
6749,6,0.111111111,3,2015-10-02T10:04:46Z,2015-11-25T08:05:39Z,54,52,2,0.037037037,2,3,2,4,"{'LD3': 1, 'LD4': 1}",2,1,"{'LD3': 1, 'LD4': 1}","Bug,GUI"
6753,5,0.003058104,1.666666667,2015-10-03T23:25:41Z,2020-03-25T13:48:57Z,1635,1632,3,0.001834862,4,4,2,3,{'LD4': 2},2,2,{'LD4': 2},Build system
6754,1,0.000600601,1,2015-10-04T11:38:25Z,2020-04-24T20:14:28Z,1665,1664,1,0.000600601,2,1,0,1,{},0,1,{},"Feature,GUI"
6756,1,1,1,2015-10-04T22:05:24Z,2015-10-05T06:47:53Z,1,0,1,1,0,1,1,0,{'LD5': 1},1,0,{'LD5': 1},
6757,3,0.1875,1.5,2015-10-04T22:42:56Z,2015-10-20T09:22:45Z,16,14,2,0.125,2,2,1,2,{'LD3': 1},1,1,{'LD3': 1},
6758,6,6,6,2015-10-05T09:46:39Z,2015-10-06T09:19:18Z,1,0,1,1,0,3,3,3,{'LD1': 3},3,0,{'LD1': 3},
6765,11,0.007447529,3.666666667,2015-10-06T01:20:29Z,2019-10-21T13:51:25Z,1477,1474,3,0.002031144,3,6,4,7,"{'LD3': 3, 'LD4': 1}",4,2,"{'LD3': 3, 'LD4': 1}",RPC/REST/ZMQ
6772,19,1.357142857,6.333333333,2015-10-06T19:02:09Z,2015-10-20T13:33:40Z,14,11,3,0.214285714,1,4,8,11,"{'LD4': 5, 'LD3': 1, 'LD5': 2}",2,2,"{'LD4': 2, 'LD3': 1, 'LD5': 1}",Build system
6773,2,0.038461538,1,2015-10-07T07:52:37Z,2015-11-27T12:50:21Z,52,50,2,0.038461538,2,2,1,1,{'LD4': 1},1,1,{'LD4': 1},GUI
6775,10,10,10,2015-10-07T16:33:08Z,2015-10-07T17:36:28Z,1,0,1,1,0,2,6,4,"{'LD4': 3, 'LD1': 3}",2,0,"{'LD4': 2, 'LD1': 1}",
6778,3,0.5,1.5,2015-10-08T04:06:37Z,2015-10-13T08:54:50Z,6,4,2,0.333333333,1,3,0,3,{},0,3,{},Build system
6784,5,0.005787037,1.25,2015-10-08T21:19:34Z,2018-02-18T16:04:42Z,864,860,4,0.00462963,4,4,2,3,"{'LD4': 1, 'LD3': 1}",2,2,"{'LD4': 1, 'LD3': 1}","Resource usage,Windows"
6786,1,0.5,1,2015-10-09T07:23:04Z,2015-10-10T08:41:48Z,2,1,1,0.5,1,1,1,0,{'LD1': 1},1,0,{'LD1': 1},
6802,2,0.038461538,2,2015-10-10T15:48:28Z,2015-12-01T13:39:49Z,52,51,1,0.019230769,2,2,1,1,{'LD3': 1},1,1,{'LD3': 1},"Build system,macOS"
6814,2,0.001207729,1,2015-10-13T02:57:26Z,2020-04-24T20:16:11Z,1656,1654,2,0.001207729,3,2,0,2,{},0,2,{},GUI
6824,15,0.008987418,3.75,2015-10-14T03:52:19Z,2020-05-08T18:13:59Z,1669,1665,4,0.002396645,3,7,6,9,"{'LD4': 4, 'LD3': 2}",3,4,"{'LD4': 1, 'LD3': 2}",Brainstorming
6826,1,0.166666667,1,2015-10-14T11:28:35Z,2015-10-20T10:21:46Z,6,5,1,0.166666667,1,1,0,1,{},0,1,{},Tests
6833,7,2.333333333,2.333333333,2015-10-15T15:14:23Z,2015-10-18T14:19:42Z,3,0,3,1,0,4,4,3,"{'LD1': 1, 'LD3': 2, 'LD4': 1}",2,2,"{'LD1': 1, 'LD3': 1, 'LD4': 1}",
6834,2,0.4,1,2015-10-15T17:11:12Z,2015-10-20T10:53:58Z,5,3,2,0.4,1,1,1,1,{'LD2': 1},1,0,{'LD2': 1},
6838,2,0.285714286,1,2015-10-16T00:14:48Z,2015-10-22T15:53:19Z,7,5,2,0.285714286,2,2,1,1,{'LD3': 1},1,1,{'LD3': 1},Feature
6840,3,0.6,1.5,2015-10-16T11:14:55Z,2015-10-21T08:49:46Z,5,3,2,0.4,3,2,3,0,"{'LD4': 2, 'LD1': 1}",2,0,"{'LD4': 2, 'LD1': 1}",Bug
6847,3,3,3,2015-10-18T13:51:56Z,2015-10-19T09:37:32Z,1,0,1,1,0,3,1,2,{'LD6': 1},1,2,{'LD6': 1},
6862,4,0.03539823,4,2015-10-21T08:48:24Z,2016-02-10T19:43:57Z,113,112,1,0.008849558,1,2,2,2,"{'LD4': 1, 'LD2': 1}",1,1,"{'LD4': 1, 'LD2': 1}","Docs,TX fees and policy"
6869,4,1,2,2015-10-22T15:36:34Z,2015-10-26T09:13:24Z,4,2,2,0.5,1,1,4,0,"{'LD1': 3, 'LD3': 1}",1,0,"{'LD1': 1, 'LD3': 1}",
6876,25,0.045537341,4.166666667,2015-10-23T06:41:14Z,2017-04-23T23:50:33Z,549,543,6,0.010928962,3,9,5,20,"{'LD3': 2, 'LD6': 1, 'LD4': 2}",4,5,"{'LD3': 2, 'LD6': 1, 'LD4': 1}","Mining,Resource usage"
6882,4,0.666666667,1.333333333,2015-10-23T20:10:45Z,2015-10-29T09:04:56Z,6,3,3,0.5,2,3,2,2,{'LD1': 2},1,2,{'LD1': 1},
6886,3,0.333333333,1.5,2015-10-24T20:42:05Z,2015-11-02T03:30:00Z,9,7,2,0.222222222,3,1,0,3,{},0,1,{},Tests
6890,1,0.055555556,1,2015-10-26T17:06:16Z,2015-11-13T12:27:37Z,18,17,1,0.055555556,1,1,1,0,{'LD4': 1},1,0,{'LD4': 1},Docs
6901,4,2,2,2015-10-29T13:28:05Z,2015-10-31T11:33:39Z,2,0,2,1,0,2,3,1,"{'LD4': 1, 'LD3': 1, 'LD5': 1}",2,0,"{'LD4': 1, 'LD3': 1, 'LD5': 1}",RPC/REST/ZMQ
6903,10,0.006097561,1.428571429,2015-10-29T15:00:09Z,2020-04-24T20:17:28Z,1640,1633,7,0.004268293,8,6,5,5,"{'LD4': 2, 'LD6': 1, 'LD3': 1, 'LD5': 1}",4,2,"{'LD4': 2, 'LD6': 1, 'LD3': 1, 'LD5': 1}","P2P,Resource usage"
6923,2,0.333333333,2,2015-10-31T16:12:57Z,2015-11-05T22:06:42Z,6,5,1,0.166666667,2,1,0,2,{},0,1,{},"Block storage,Data corruption"
6924,3,0.001817081,3,2015-10-31T19:05:42Z,2020-05-08T18:16:31Z,1651,1650,1,0.000605694,1,3,0,3,{},0,3,{},Wallet
6941,12,0.015384615,1.5,2015-11-04T19:48:37Z,2017-12-23T09:00:55Z,780,772,8,0.01025641,6,7,3,9,"{'LD3': 1, 'LD6': 1, 'LD4': 1}",3,4,"{'LD3': 1, 'LD6': 1, 'LD4': 1}","Docs,RPC/REST/ZMQ,good first issue"
6947,3,0.5,3,2015-11-04T23:12:01Z,2015-11-10T10:53:16Z,6,5,1,0.166666667,1,3,2,1,"{'LD1': 1, 'LD4': 1}",2,1,"{'LD1': 1, 'LD4': 1}",Wallet
6949,5,1.25,1.666666667,2015-11-05T15:55:06Z,2015-11-09T07:15:14Z,4,1,3,0.75,1,3,3,2,{'LD4': 3},3,0,{'LD4': 3},Data corruption
6950,1,0.066666667,1,2015-11-05T16:51:29Z,2015-11-19T18:39:16Z,15,14,1,0.066666667,1,1,0,1,{},0,1,{},Build system
6957,2,0.105263158,1,2015-11-06T05:57:50Z,2015-11-24T08:19:28Z,19,17,2,0.105263158,1,1,2,0,"{'LD4': 1, 'LD5': 1}",1,0,"{'LD4': 1, 'LD5': 1}",Upstream
6959,3,0.001835985,3,2015-11-06T09:37:47Z,2020-04-27T00:04:30Z,1634,1633,1,0.000611995,1,2,3,0,"{'LD4': 1, 'LD3': 2}",2,0,"{'LD4': 1, 'LD3': 2}","Mempool,Wallet"
6960,1,1,1,2015-11-06T10:16:27Z,2015-11-06T10:39:48Z,1,0,1,1,0,1,0,1,{},0,1,{},
6963,19,4.75,6.333333333,2015-11-06T21:01:21Z,2015-11-10T15:29:22Z,4,1,3,0.75,1,10,6,13,"{'LD1': 1, 'LD4': 3, 'LD3': 2}",4,6,"{'LD1': 1, 'LD4': 3, 'LD3': 2}",Bug
6971,2,0.666666667,1,2015-11-09T09:39:43Z,2015-11-11T17:30:32Z,3,1,2,0.666666667,1,1,2,0,{'LD3': 2},1,0,{'LD3': 1},P2P
6972,9,0.007550336,3,2015-11-09T11:15:33Z,2019-02-12T20:59:54Z,1192,1189,3,0.002516779,1,5,1,8,{'LD1': 1},1,4,{'LD1': 1},Mempool
6977,3,0.002622378,1.5,2015-11-09T23:30:44Z,2018-12-27T17:23:49Z,1144,1142,2,0.001748252,2,2,1,2,{'LD4': 1},1,1,{'LD4': 1},TX fees and policy
6989,2,0.001229256,1,2015-11-11T17:11:01Z,2020-04-24T20:18:27Z,1627,1625,2,0.001229256,2,2,0,2,{},0,2,{},Validation
6994,2,0.25,2,2015-11-12T07:13:01Z,2015-11-19T14:17:32Z,8,7,1,0.125,2,2,1,1,{'LD4': 1},1,1,{'LD4': 1},
6995,12,0.007317073,12,2015-11-12T09:18:33Z,2020-05-08T18:18:35Z,1640,1639,1,0.000609756,1,4,3,9,"{'LD3': 1, 'LD4': 1, 'LD1': 1}",3,1,"{'LD3': 1, 'LD4': 1, 'LD1': 1}",RPC/REST/ZMQ
7001,7,0.012658228,3.5,2015-11-13T02:18:22Z,2017-05-18T12:44:48Z,553,551,2,0.003616637,2,4,2,5,"{'LD1': 1, 'LD4': 1}",2,2,"{'LD1': 1, 'LD4': 1}","Resource usage,Windows"
7002,7,0.008805031,1.75,2015-11-13T07:41:27Z,2018-01-15T14:58:31Z,795,791,4,0.005031447,4,4,4,3,"{'LD1': 2, 'LD4': 2}",2,2,"{'LD1': 2, 'LD4': 2}",Tests
7009,2,0.142857143,2,2015-11-13T16:37:27Z,2015-11-27T13:26:51Z,14,13,1,0.071428571,1,2,1,1,{'LD3': 1},1,1,{'LD3': 1},Docs
7012,5,1.666666667,5,2015-11-13T22:08:32Z,2015-11-16T15:21:17Z,3,2,1,0.333333333,1,3,1,4,{'LD2': 1},1,2,{'LD2': 1},RPC/REST/ZMQ
7014,3,0.001830384,1.5,2015-11-13T23:45:41Z,2020-05-08T23:48:24Z,1639,1637,2,0.001220256,2,3,0,3,{},0,3,{},"Feature,GUI"
7015,25,0.015262515,8.333333333,2015-11-14T01:26:43Z,2020-05-08T18:20:46Z,1638,1635,3,0.001831502,2,6,5,20,"{'LD1': 3, 'LD3': 1, 'LD4': 1}",3,3,"{'LD1': 2, 'LD3': 1, 'LD4': 1}",Mining
7017,20,0.289855072,3.333333333,2015-11-14T15:49:33Z,2016-01-22T08:48:03Z,69,63,6,0.086956522,4,5,6,14,"{'LD3': 5, 'LD4': 1}",2,3,"{'LD3': 2, 'LD4': 1}",GUI
7018,10,0.909090909,3.333333333,2015-11-14T16:39:52Z,2015-11-25T10:32:11Z,11,8,3,0.272727273,3,3,5,5,"{'LD4': 1, 'LD1': 2, 'LD5': 2}",2,1,"{'LD4': 1, 'LD1': 1, 'LD5': 2}",Windows
7024,1,1,1,2015-11-16T07:54:25Z,2015-11-16T08:52:57Z,1,0,1,1,0,1,0,1,{},0,1,{},
7031,3,0.375,3,2015-11-16T15:22:16Z,2015-11-24T07:42:50Z,8,7,1,0.125,1,2,2,1,"{'LD4': 1, 'LD2': 1}",1,1,"{'LD4': 1, 'LD2': 1}",RPC/REST/ZMQ
7032,1,0.071428571,1,2015-11-16T15:25:55Z,2015-11-30T13:20:40Z,14,13,1,0.071428571,1,1,1,0,{'LD3': 1},1,0,{'LD3': 1},P2P
7033,2,0.001469508,1,2015-11-16T16:24:57Z,2019-08-07T20:35:02Z,1361,1359,2,0.001469508,2,2,1,1,{'LD1': 1},1,1,{'LD1': 1},Build system
7036,5,1.666666667,2.5,2015-11-17T01:58:34Z,2015-11-19T22:31:25Z,3,1,2,0.666666667,1,3,3,2,"{'LD1': 2, 'LD5': 1}",2,1,"{'LD1': 2, 'LD5': 1}",Windows
7038,7,0.004771643,1.75,2015-11-17T09:14:19Z,2019-11-22T20:01:38Z,1467,1463,4,0.002726653,5,6,1,6,{'LD3': 1},1,5,{'LD3': 1},Validation
7039,6,0.003183024,2,2015-11-17T12:09:31Z,2021-01-14T07:53:07Z,1885,1882,3,0.001591512,2,5,1,5,{'LD1': 1},1,4,{'LD1': 1},"Feature,GUI"
7043,7,3.5,7,2015-11-17T17:40:25Z,2015-11-19T14:20:17Z,2,1,1,0.5,1,3,3,4,"{'LD3': 2, 'LD1': 1}",1,2,"{'LD3': 1, 'LD1': 1}",
7049,1,0.000617284,1,2015-11-18T01:02:00Z,2020-04-24T20:20:13Z,1620,1619,1,0.000617284,1,1,0,1,{},0,1,{},"Feature,P2P"
7054,8,0.025316456,4,2015-11-18T14:29:37Z,2016-09-28T17:55:11Z,316,314,2,0.006329114,1,4,4,4,"{'LD1': 1, 'LD3': 3}",1,3,"{'LD1': 1, 'LD3': 1}",Wallet
7073,1,1,1,2015-11-21T19:28:08Z,2015-11-22T18:35:12Z,1,0,1,1,0,1,1,0,{'LD2': 1},1,0,{'LD2': 1},
7077,7,2.333333333,2.333333333,2015-11-22T18:34:48Z,2015-11-25T07:17:05Z,3,0,3,1,0,3,4,3,"{'LD4': 2, 'LD1': 2}",3,0,"{'LD4': 1, 'LD1': 2}",GUI
7080,1,0.2,1,2015-11-23T02:37:07Z,2015-11-27T13:08:49Z,5,4,1,0.2,1,1,0,1,{},0,1,{},
7085,8,0.040201005,4,2015-11-23T23:52:31Z,2016-06-09T08:51:13Z,199,197,2,0.010050251,2,4,2,6,"{'LD3': 1, 'LD4': 1}",1,3,"{'LD3': 1, 'LD4': 1}","Build system,macOS"
7086,9,2.25,2.25,2015-11-24T02:52:57Z,2015-11-27T13:17:04Z,4,0,4,1,0,5,3,6,"{'LD3': 2, 'LD4': 1}",3,2,"{'LD3': 2, 'LD4': 1}",Tests
7089,2,2,2,2015-11-24T11:36:57Z,2015-11-25T07:58:27Z,1,0,1,1,0,2,1,1,{'LD1': 1},1,1,{'LD1': 1},
7097,21,0.012907191,2.1,2015-11-25T17:28:42Z,2020-05-08T18:21:43Z,1627,1617,10,0.006146281,6,8,5,16,"{'LD1': 2, 'LD4': 3}",4,4,"{'LD1': 2, 'LD4': 2}","Feature,GUI"
7098,4,0.002164502,2,2015-11-25T21:40:58Z,2020-12-16T14:49:21Z,1848,1846,2,0.001082251,2,3,1,3,{'LD3': 1},1,2,{'LD3': 1},P2P
7108,1,0.000620732,1,2015-11-26T22:51:36Z,2020-04-24T20:28:12Z,1611,1610,1,0.000620732,1,1,0,1,{},0,1,{},"GUI,Resource usage"
7109,2,2,2,2015-11-27T03:51:58Z,2015-11-27T07:43:19Z,1,0,1,1,0,2,1,1,{'LD5': 1},1,1,{'LD5': 1},
7110,6,6,6,2015-11-27T07:45:03Z,2015-11-27T12:28:58Z,1,0,1,1,0,3,3,3,"{'LD2': 1, 'LD3': 1, 'LD4': 1}",2,1,"{'LD2': 1, 'LD3': 1, 'LD4': 1}",macOS
7120,1,0.25,1,2015-11-27T20:21:28Z,2015-12-01T12:32:33Z,4,3,1,0.25,1,1,0,1,{},0,1,{},Tests
7121,1,1,1,2015-11-27T20:36:14Z,2015-11-28T05:53:02Z,1,0,1,1,0,1,0,1,{},0,1,{},Data corruption
7130,2,2,2,2015-11-29T12:38:43Z,2015-11-30T09:34:12Z,1,0,1,1,0,2,1,1,{'LD3': 1},1,1,{'LD3': 1},RPC/REST/ZMQ
7138,3,3,3,2015-12-01T00:01:14Z,2015-12-01T12:20:46Z,1,0,1,1,0,2,0,3,{},0,2,{},GUI
7139,4,0.051282051,1.333333333,2015-12-01T00:04:49Z,2016-02-16T22:43:52Z,78,75,3,0.038461538,2,2,3,1,"{'LD4': 1, 'LD3': 1, 'LD1': 1}",2,0,"{'LD4': 1, 'LD3': 1, 'LD1': 1}","GUI,Linux/Unix"
7160,4,0.024691358,2,2015-12-03T10:11:28Z,2016-05-12T10:32:52Z,162,160,2,0.012345679,1,3,1,3,{'LD4': 1},1,2,{'LD4': 1},"Feature,GUI"
7161,8,1.6,2,2015-12-03T10:20:16Z,2015-12-07T12:27:43Z,5,1,4,0.8,1,5,4,4,"{'LD4': 2, 'LD3': 1, 'LD1': 1}",3,2,"{'LD4': 2, 'LD3': 1, 'LD1': 1}","Block storage,Data corruption"
7162,1,0.002331002,1,2015-12-03T11:53:30Z,2017-02-03T16:19:20Z,429,428,1,0.002331002,2,1,0,1,{},0,1,{},"Build system,Utils/log/libs"
7163,10,0.029069767,2,2015-12-03T12:40:15Z,2016-11-11T10:13:55Z,344,339,5,0.014534884,4,4,4,6,"{'LD5': 1, 'LD3': 2, 'LD4': 1}",3,1,"{'LD5': 1, 'LD3': 2, 'LD4': 1}",macOS
7172,5,1.25,2.5,2015-12-04T20:09:38Z,2015-12-08T06:52:07Z,4,2,2,0.5,2,2,4,1,"{'LD4': 2, 'LD1': 2}",2,0,"{'LD4': 1, 'LD1': 2}",macOS
7175,3,0.020689655,1,2015-12-05T23:02:27Z,2016-04-28T11:07:47Z,145,142,3,0.020689655,4,3,2,1,"{'LD4': 1, 'LD3': 1}",2,1,"{'LD4': 1, 'LD3': 1}","Build system,macOS"
7176,10,0.243902439,2.5,2015-12-06T01:14:49Z,2016-01-15T14:23:33Z,41,37,4,0.097560976,2,4,5,5,"{'LD3': 2, 'LD1': 1, 'LD4': 1, 'LD5': 1}",4,0,"{'LD3': 2, 'LD1': 1, 'LD4': 1, 'LD5': 1}",Validation
7178,3,0.004694836,1.5,2015-12-07T06:24:09Z,2017-09-05T13:33:40Z,639,637,2,0.00312989,1,3,2,1,"{'LD5': 1, 'LD3': 1}",2,1,"{'LD5': 1, 'LD3': 1}",TX fees and policy
7182,1,1,1,2015-12-07T17:02:16Z,2015-12-08T14:40:18Z,1,0,1,1,0,1,1,0,{'LD5': 1},1,0,{'LD5': 1},
7189,2,0.024096386,2,2015-12-09T00:17:54Z,2016-02-29T08:40:53Z,83,82,1,0.012048193,1,2,1,1,{'LD3': 1},1,1,{'LD3': 1},"Build system,GUI"
7191,8,0.285714286,4,2015-12-09T09:27:13Z,2016-01-05T11:17:13Z,28,26,2,0.071428571,1,2,6,2,"{'LD4': 3, 'LD3': 1, 'LD1': 1, 'LD5': 1}",2,0,"{'LD4': 2, 'LD3': 1, 'LD1': 1, 'LD5': 1}",Wallet
7195,1,0.00062461,1,2015-12-09T19:56:56Z,2020-04-26T20:58:23Z,1601,1600,1,0.00062461,1,1,0,1,{},0,1,{},"GUI,P2P"
7204,4,0.097560976,1.333333333,2015-12-13T10:57:40Z,2016-01-22T12:18:09Z,41,38,3,0.073170732,3,3,2,2,"{'LD4': 1, 'LD5': 1}",2,1,"{'LD4': 1, 'LD5': 1}",Build system
7207,1,1,1,2015-12-14T02:30:52Z,2015-12-14T08:15:10Z,1,0,1,1,0,1,0,1,{},0,1,{},Build system
7210,1,1,1,2015-12-14T15:06:12Z,2015-12-15T08:27:02Z,1,0,1,1,0,1,0,1,{},0,1,{},
7211,3,0.046875,1.5,2015-12-14T15:51:34Z,2016-02-16T12:02:37Z,64,62,2,0.03125,3,3,2,1,"{'LD4': 1, 'LD1': 1}",2,1,"{'LD4': 1, 'LD1': 1}",
7215,4,1,2,2015-12-15T13:37:27Z,2015-12-19T10:22:25Z,4,2,2,0.5,1,2,2,2,"{'LD2': 1, 'LD5': 1}",2,0,"{'LD2': 1, 'LD5': 1}",
7223,2,0.015748031,2,2015-12-16T20:08:15Z,2016-04-20T21:31:32Z,127,126,1,0.007874016,1,2,0,2,{},0,2,{},Wallet
7227,8,0.275862069,8,2015-12-17T20:52:54Z,2016-01-15T15:24:02Z,29,28,1,0.034482759,1,5,3,5,"{'LD1': 2, 'LD4': 1}",2,3,"{'LD1': 1, 'LD4': 1}","P2P,RPC/REST/ZMQ"
7228,1,0.002293578,1,2015-12-18T07:00:32Z,2017-02-25T09:04:29Z,436,435,1,0.002293578,2,1,0,1,{},0,1,{},Bug
7231,1,0.05,1,2015-12-18T16:35:59Z,2016-01-07T11:35:53Z,20,19,1,0.05,1,1,0,1,{},0,1,{},
7233,9,0.023684211,1.285714286,2015-12-19T14:20:45Z,2017-01-01T19:50:50Z,380,373,7,0.018421053,5,8,5,4,"{'LD3': 3, 'LD1': 1, 'LD5': 1}",5,3,"{'LD3': 3, 'LD1': 1, 'LD5': 1}",Data corruption
7234,5,0.094339623,5,2015-12-19T20:09:57Z,2016-02-10T17:57:12Z,53,52,1,0.018867925,2,2,3,2,"{'LD3': 2, 'LD4': 1}",2,0,"{'LD3': 1, 'LD4': 1}",Wallet
7235,22,0.078571429,3.142857143,2015-12-20T06:27:25Z,2016-09-24T08:05:37Z,280,273,7,0.025,4,8,4,18,{'LD3': 4},3,5,{'LD3': 3},"GUI,Wallet,good first issue"
7239,5,0.086206897,1.25,2015-12-21T11:05:18Z,2016-02-16T12:01:26Z,58,54,4,0.068965517,2,4,1,4,{'LD5': 1},1,3,{'LD5': 1},Wallet
7240,2,2,2,2015-12-21T14:27:40Z,2015-12-21T19:58:02Z,1,0,1,1,0,2,1,1,{'LD3': 1},1,1,{'LD3': 1},Wallet
7241,5,0.003123048,2.5,2015-12-21T16:14:37Z,2020-05-09T12:58:28Z,1601,1599,2,0.001249219,2,3,1,4,{'LD4': 1},1,2,{'LD4': 1},Mempool
7244,2,0.035087719,2,2015-12-22T10:35:27Z,2016-02-16T12:30:06Z,57,56,1,0.01754386,1,1,1,1,{'LD4': 1},1,0,{'LD4': 1},macOS
7246,1,0.052631579,1,2015-12-22T15:00:03Z,2016-01-09T15:30:31Z,19,18,1,0.052631579,1,1,0,1,{},0,1,{},Tests
7247,2,2,2,2015-12-23T00:18:56Z,2015-12-23T09:07:10Z,1,0,1,1,0,2,0,2,{},0,2,{},Wallet
7248,2,0.5,1,2015-12-23T00:29:03Z,2015-12-26T04:18:07Z,4,2,2,0.5,2,2,0,2,{},0,2,{},"Data corruption,UTXO Db and Indexes,Windows"
7249,8,0.145454545,2.666666667,2015-12-23T14:51:44Z,2016-02-16T11:58:03Z,55,52,3,0.054545455,1,4,2,6,"{'LD1': 1, 'LD2': 1}",1,3,"{'LD1': 1, 'LD2': 1}",Wallet
7254,3,0.088235294,1.5,2015-12-25T20:11:39Z,2016-01-28T12:21:59Z,34,32,2,0.058823529,2,2,0,3,{},0,2,{},Wallet
7258,1,0.045454545,1,2015-12-26T18:05:28Z,2016-01-16T21:58:44Z,22,21,1,0.045454545,1,1,0,1,{},0,1,{},UTXO Db and Indexes
7260,1,0.111111111,1,2015-12-28T07:25:11Z,2016-01-05T11:13:14Z,9,8,1,0.111111111,1,1,1,0,{'LD4': 1},1,0,{'LD4': 1},Wallet
7261,7,2.333333333,2.333333333,2015-12-28T17:26:26Z,2015-12-30T23:41:33Z,3,0,3,1,0,4,5,2,"{'LD1': 3, 'LD4': 1, 'LD3': 1}",3,1,"{'LD1': 3, 'LD4': 1, 'LD3': 1}",
7265,8,0.074766355,2,2015-12-30T19:59:08Z,2016-04-15T14:43:54Z,107,103,4,0.037383178,3,6,2,6,"{'LD2': 1, 'LD3': 1}",2,4,"{'LD2': 1, 'LD3': 1}","Build system,Feature"
7269,2,2,2,2016-01-01T06:50:37Z,2016-01-01T16:44:05Z,1,0,1,1,0,2,0,2,{},0,2,{},macOS
7271,1,0.333333333,1,2016-01-01T19:26:20Z,2016-01-04T08:10:43Z,3,2,1,0.333333333,1,1,0,1,{},0,1,{},
7275,11,2.2,5.5,2016-01-03T15:36:48Z,2016-01-08T10:01:54Z,5,3,2,0.4,1,3,4,7,"{'LD4': 2, 'LD3': 1, 'LD5': 1}",2,1,"{'LD4': 1, 'LD3': 1, 'LD5': 1}",Bug
7277,7,7,7,2016-01-03T15:57:08Z,2016-01-03T16:25:25Z,1,0,1,1,0,1,5,2,{'LD4': 5},1,0,{'LD4': 1},
7278,1,0.5,1,2016-01-03T16:18:48Z,2016-01-05T12:02:12Z,2,1,1,0.5,1,1,0,1,{},0,1,{},"Bug,GUI"
7279,4,2,4,2016-01-03T16:51:01Z,2016-01-05T12:55:30Z,2,1,1,0.5,1,2,1,3,{'LD5': 1},1,1,{'LD5': 1},GUI
7284,1,1,1,2016-01-04T12:25:43Z,2016-01-04T12:51:35Z,1,0,1,1,0,1,1,0,{'LD4': 1},1,0,{'LD4': 1},
7285,2,2,2,2016-01-04T12:36:13Z,2016-01-05T11:24:25Z,1,0,1,1,0,2,1,1,{'LD3': 1},1,1,{'LD3': 1},
7299,2,2,2,2016-01-05T20:31:50Z,2016-01-06T09:58:15Z,1,0,1,1,0,2,0,2,{},0,2,{},
7301,1,1,1,2016-01-05T21:17:35Z,2016-01-05T21:24:17Z,1,0,1,1,0,1,1,0,{'LD1': 1},1,0,{'LD1': 1},
7303,2,1,1,2016-01-06T11:07:10Z,2016-01-08T08:23:26Z,2,0,2,1,0,2,1,1,{'LD3': 1},1,1,{'LD3': 1},Windows
7314,3,3,3,2016-01-08T03:20:24Z,2016-01-08T09:59:14Z,1,0,1,1,0,3,1,2,{'LD3': 1},1,2,{'LD3': 1},
7315,3,0.001642036,1,2016-01-08T04:45:58Z,2021-01-07T17:13:21Z,1827,1824,3,0.001642036,4,3,2,1,"{'LD4': 1, 'LD6': 1}",2,1,"{'LD4': 1, 'LD6': 1}",Wallet
7316,2,2,2,2016-01-08T08:36:44Z,2016-01-08T16:34:47Z,1,0,1,1,0,1,1,1,{'LD2': 1},1,0,{'LD2': 1},GUI
7325,2,0.002541296,1,2016-01-10T02:26:22Z,2018-03-06T18:49:18Z,787,785,2,0.002541296,2,2,1,1,{'LD3': 1},1,1,{'LD3': 1},Build system
7330,1,1,1,2016-01-12T20:34:27Z,2016-01-12T21:39:35Z,1,0,1,1,0,1,1,0,{'LD3': 1},1,0,{'LD3': 1},
7331,8,8,8,2016-01-12T22:13:26Z,2016-01-13T15:01:17Z,1,0,1,1,0,4,4,4,"{'LD3': 3, 'LD1': 1}",3,1,"{'LD3': 3, 'LD1': 1}",
7337,1,0.001277139,1,2016-01-13T21:07:37Z,2018-03-06T18:48:48Z,783,782,1,0.001277139,2,1,0,1,{},0,1,{},"Build system,macOS"
7341,7,0.043478261,1.166666667,2016-01-14T02:20:40Z,2016-06-22T11:47:46Z,161,155,6,0.037267081,7,4,0,7,{},0,4,{},"GUI,Upstream,Windows"
7343,8,0.076190476,1.142857143,2016-01-14T16:30:45Z,2016-04-28T11:06:39Z,105,98,7,0.066666667,2,5,4,4,"{'LD6': 1, 'LD4': 2, 'LD2': 1}",2,3,"{'LD6': 1, 'LD4': 1, 'LD2': 1}","Feature,Wallet"
7344,4,0.015444015,1,2016-01-14T17:18:09Z,2016-09-29T06:13:13Z,259,255,4,0.015444015,3,2,3,1,"{'LD3': 2, 'LD1': 1}",2,0,"{'LD3': 1, 'LD1': 1}","RPC/REST/ZMQ,Resource usage"
7355,4,0.002538071,1,2016-01-15T13:09:21Z,2020-05-08T18:28:22Z,1576,1572,4,0.002538071,3,4,3,1,"{'LD4': 1, 'LD3': 1, 'LD2': 1}",3,1,"{'LD4': 1, 'LD3': 1, 'LD2': 1}","Block storage,Data corruption,UTXO Db and Indexes"
7357,1,0.5,1,2016-01-16T13:43:31Z,2016-01-18T08:18:21Z,2,1,1,0.5,1,1,0,1,{},0,1,{},
7358,1,1,1,2016-01-16T22:25:00Z,2016-01-17T02:04:25Z,1,0,1,1,0,1,0,1,{},0,1,{},
7361,2,0.083333333,1,2016-01-17T02:17:27Z,2016-02-09T16:09:18Z,24,22,2,0.083333333,1,2,1,1,{'LD4': 1},1,1,{'LD4': 1},P2P
7365,5,0.013736264,1.25,2016-01-17T19:00:31Z,2017-01-15T06:45:04Z,364,360,4,0.010989011,3,5,3,2,"{'LD3': 1, 'LD6': 1, 'LD5': 1}",3,2,"{'LD3': 1, 'LD6': 1, 'LD5': 1}","Block storage,Feature,RPC/REST/ZMQ"
7366,11,1.1,3.666666667,2016-01-17T19:55:34Z,2016-01-27T16:53:55Z,10,7,3,0.3,2,3,7,4,"{'LD4': 3, 'LD3': 3, 'LD1': 1}",3,0,"{'LD4': 2, 'LD3': 2, 'LD1': 1}","Bug,GUI"
7369,3,0.001907184,1,2016-01-18T11:27:04Z,2020-05-08T18:28:52Z,1573,1570,3,0.001907184,3,2,1,2,{'LD3': 1},1,1,{'LD3': 1},"Feature,GUI"
7375,8,1.142857143,4,2016-01-18T20:54:35Z,2016-01-25T16:28:13Z,7,5,2,0.285714286,1,6,3,5,"{'LD1': 2, 'LD3': 1}",2,4,"{'LD1': 2, 'LD3': 1}",Windows
7377,3,0.001908397,3,2016-01-19T03:49:14Z,2020-05-08T18:29:48Z,1572,1571,1,0.000636132,2,2,0,3,{},0,2,{},"GUI,P2P"
7382,7,0.01443299,3.5,2016-01-20T09:18:40Z,2017-05-18T12:43:54Z,485,483,2,0.004123711,2,4,7,0,"{'LD4': 6, 'LD3': 1}",4,0,"{'LD4': 4, 'LD3': 1}","Block storage,Data corruption"
7389,1,0.000642261,1,2016-01-22T02:27:12Z,2020-04-27T00:06:39Z,1557,1556,1,0.000642261,2,1,0,1,{},0,1,{},Docs
7393,4,4,4,2016-01-22T12:35:02Z,2016-01-22T13:22:38Z,1,0,1,1,0,2,3,1,"{'LD3': 1, 'LD4': 2}",2,0,"{'LD3': 1, 'LD4': 2}",Scripts and tools
7394,14,0.144329897,4.666666667,2016-01-22T14:48:00Z,2016-04-28T10:49:01Z,97,94,3,0.030927835,2,4,2,12,"{'LD6': 1, 'LD3': 1}",1,3,"{'LD6': 1, 'LD3': 1}",Build system
7397,2,2,2,2016-01-22T19:47:43Z,2016-01-22T20:56:23Z,1,0,1,1,0,2,1,1,{'LD3': 1},1,1,{'LD3': 1},GUI
7401,3,1.5,1.5,2016-01-23T15:23:02Z,2016-01-25T07:57:55Z,2,0,2,1,0,2,1,2,{'LD3': 1},1,1,{'LD3': 1},macOS
7406,1,1,1,2016-01-24T17:58:22Z,2016-01-25T15:51:53Z,1,0,1,1,0,1,0,1,{},0,1,{},
7407,5,0.033333333,1.25,2016-01-24T19:31:57Z,2016-06-22T11:47:05Z,150,146,4,0.026666667,1,5,2,3,{'LD4': 2},2,3,{'LD4': 2},"Feature,GUI"
7411,3,1,3,2016-01-25T04:38:20Z,2016-01-27T11:39:25Z,3,2,1,0.333333333,1,3,1,2,{'LD3': 1},1,2,{'LD3': 1},Build system
7412,3,0.02027027,1.5,2016-01-25T05:12:39Z,2016-06-20T12:42:41Z,148,146,2,0.013513514,1,3,1,2,{'LD1': 1},1,2,{'LD1': 1},"Brainstorming,Consensus,Resource usage"
7418,2,0.5,2,2016-01-26T01:35:52Z,2016-01-29T11:51:59Z,4,3,1,0.25,1,1,1,1,{'LD3': 1},1,0,{'LD3': 1},"Bug,GUI"
7420,1,1,1,2016-01-26T13:31:59Z,2016-01-27T10:31:18Z,1,0,1,1,0,1,0,1,{},0,1,{},"Bug,Build system"
7426,3,0.006289308,1.5,2016-01-27T13:26:09Z,2017-05-18T12:44:20Z,477,475,2,0.004192872,2,3,1,2,{'LD4': 1},1,2,{'LD4': 1},"Block storage,Data corruption"
7427,1,1,1,2016-01-27T17:46:03Z,2016-01-27T19:55:40Z,1,0,1,1,0,1,1,0,{'LD4': 1},1,0,{'LD4': 1},
7430,2,0.006644518,1,2016-01-27T20:32:12Z,2016-11-23T06:09:18Z,301,299,2,0.006644518,2,2,1,1,{'LD3': 1},1,1,{'LD3': 1},Docs
7432,2,2,2,2016-01-28T07:13:01Z,2016-01-28T10:15:42Z,1,0,1,1,0,2,1,1,{'LD6': 1},1,1,{'LD6': 1},Refactoring
7433,5,0.047169811,1.25,2016-01-28T07:24:19Z,2016-05-12T09:46:24Z,106,102,4,0.037735849,3,4,2,3,"{'LD3': 1, 'LD4': 1}",2,2,"{'LD3': 1, 'LD4': 1}","Refactoring,good first issue"
7434,2,0.003231018,1,2016-01-28T08:19:29Z,2017-10-07T14:46:51Z,619,617,2,0.003231018,2,1,0,2,{},0,1,{},Refactoring
7435,1,0.000716846,1,2016-01-28T14:58:44Z,2019-11-22T20:02:49Z,1395,1394,1,0.000716846,2,1,1,0,{'LD3': 1},1,0,{'LD3': 1},P2P
7442,6,0.222222222,3,2016-01-29T12:07:03Z,2016-02-24T19:03:24Z,27,25,2,0.074074074,1,6,5,1,{'LD3': 5},5,1,{'LD3': 5},"Feature,RPC/REST/ZMQ"
7446,3,3,3,2016-01-31T12:35:49Z,2016-01-31T12:52:03Z,1,0,1,1,0,3,1,2,{'LD3': 1},1,2,{'LD3': 1},
7447,1,0.083333333,1,2016-01-31T17:36:16Z,2016-02-12T12:07:11Z,12,11,1,0.083333333,1,1,1,0,{'LD2': 1},1,0,{'LD2': 1},"Build system,Linux/Unix"
7449,1,0.000646412,1,2016-02-01T03:05:51Z,2020-04-26T20:59:11Z,1547,1546,1,0.000646412,2,1,1,0,{'LD4': 1},1,0,{'LD4': 1},"Feature,P2P"
7452,1,0.111111111,1,2016-02-01T10:00:46Z,2016-02-09T12:53:17Z,9,8,1,0.111111111,2,1,1,0,{'LD2': 1},1,0,{'LD2': 1},P2P
7456,4,0.00258565,2,2016-02-01T16:14:35Z,2020-04-26T17:28:09Z,1547,1545,2,0.001292825,2,3,0,4,{},0,3,{},Brainstorming
7462,4,0.666666667,2,2016-02-03T19:03:14Z,2016-02-09T07:52:17Z,6,4,2,0.333333333,1,2,0,4,{},0,2,{},RPC/REST/ZMQ
7466,6,0.071428571,2,2016-02-04T13:33:17Z,2016-04-28T11:02:53Z,84,81,3,0.035714286,2,3,1,5,{'LD6': 1},1,2,{'LD6': 1},Build system
7470,15,0.12605042,1.5,2016-02-05T02:25:46Z,2016-06-02T11:21:44Z,119,109,10,0.084033613,7,4,5,10,"{'LD3': 2, 'LD4': 1, 'LD5': 1, 'LD2': 1}",2,2,"{'LD3': 2, 'LD4': 1, 'LD5': 1, 'LD2': 1}",P2P
7471,7,0.02991453,1.4,2016-02-05T04:07:38Z,2016-09-25T06:16:57Z,234,229,5,0.021367521,5,3,1,6,{'LD4': 1},1,2,{'LD4': 1},"Build system,Docs,Resource usage"
7474,1,0.2,1,2016-02-06T09:37:43Z,2016-02-11T08:55:51Z,5,4,1,0.2,2,1,0,1,{},0,1,{},P2P
7476,3,1.5,3,2016-02-07T12:49:28Z,2016-02-09T10:08:50Z,2,1,1,0.5,1,3,2,1,"{'LD6': 1, 'LD3': 1}",2,1,"{'LD6': 1, 'LD3': 1}",RPC/REST/ZMQ
7484,5,0.098039216,1.25,2016-02-08T21:42:57Z,2016-03-30T21:01:43Z,51,47,4,0.078431373,4,3,3,2,"{'LD3': 1, 'LD1': 1, 'LD5': 1}",3,0,"{'LD3': 1, 'LD1': 1, 'LD5': 1}","Feature,GUI"
7486,9,0.1125,2.25,2016-02-09T00:04:04Z,2016-04-28T11:02:39Z,80,76,4,0.05,3,5,3,6,"{'LD1': 2, 'LD4': 1}",3,2,"{'LD1': 2, 'LD4': 1}","RPC/REST/ZMQ,Resource usage"
7488,3,0.004178273,3,2016-02-09T09:28:52Z,2018-01-26T13:46:53Z,718,717,1,0.001392758,1,3,1,2,{'LD3': 1},1,2,{'LD3': 1},RPC/REST/ZMQ
7492,2,0.2,1,2016-02-09T20:30:35Z,2016-02-19T09:34:35Z,10,8,2,0.2,2,1,1,1,{'LD1': 1},1,0,{'LD1': 1},Build system
7494,9,4.5,4.5,2016-02-10T01:48:06Z,2016-02-11T07:58:08Z,2,0,2,1,0,4,2,7,"{'LD2': 1, 'LD3': 1}",2,2,"{'LD2': 1, 'LD3': 1}","Bug,Wallet"
7496,3,0.088235294,1,2016-02-10T09:32:55Z,2016-03-15T08:30:10Z,34,31,3,0.088235294,3,3,0,3,{},0,3,{},RPC/REST/ZMQ
7497,2,2,2,2016-02-10T10:40:45Z,2016-02-10T12:09:21Z,1,0,1,1,0,1,2,0,"{'LD4': 1, 'LD1': 1}",1,0,"{'LD4': 1, 'LD1': 1}","GUI,Upstream"
7499,1,1,1,2016-02-10T13:01:38Z,2016-02-10T13:06:08Z,1,0,1,1,0,1,0,1,{},0,1,{},GUI
7508,3,3,3,2016-02-11T03:22:50Z,2016-02-11T07:57:16Z,1,0,1,1,0,3,1,2,{'LD4': 1},1,2,{'LD4': 1},
7512,22,0.050113895,3.142857143,2016-02-11T08:32:24Z,2017-04-25T05:22:34Z,439,432,7,0.01594533,4,6,4,18,"{'LD3': 2, 'LD4': 1, 'LD5': 1}",2,4,"{'LD3': 2, 'LD4': 1, 'LD5': 1}",
7515,3,3,3,2016-02-11T11:00:09Z,2016-02-11T11:52:07Z,1,0,1,1,0,1,1,2,{'LD4': 1},1,0,{'LD4': 1},Linux/Unix
7516,4,0.571428571,2,2016-02-11T15:38:45Z,2016-02-18T10:07:17Z,7,5,2,0.285714286,2,3,1,3,{'LD3': 1},1,2,{'LD3': 1},Docs
7519,3,0.230769231,3,2016-02-11T18:26:46Z,2016-02-24T10:45:35Z,13,12,1,0.076923077,1,2,3,0,"{'LD4': 2, 'LD3': 1}",2,0,"{'LD4': 2, 'LD3': 1}",Build system
7525,23,0.014857881,3.285714286,2016-02-12T18:08:38Z,2020-05-08T18:30:18Z,1548,1541,7,0.004521964,4,11,8,15,"{'LD4': 5, 'LD1': 1, 'LD3': 2}",7,4,"{'LD4': 4, 'LD1': 1, 'LD3': 2}","Feature,Wallet"
7532,1,0.5,1,2016-02-13T21:27:34Z,2016-02-15T12:39:00Z,2,1,1,0.5,1,1,0,1,{},0,1,{},Docs
7535,5,0.555555556,2.5,2016-02-15T13:40:03Z,2016-02-24T10:27:38Z,9,7,2,0.222222222,1,4,3,2,"{'LD3': 1, 'LD1': 2}",3,1,"{'LD3': 1, 'LD1': 2}","Block storage,Brainstorming,UTXO Db and Indexes"
7538,3,0.041666667,1.5,2016-02-16T13:46:11Z,2016-04-28T11:01:49Z,72,70,2,0.027777778,2,2,0,3,{},0,2,{},Tests
7545,1,0.5,1,2016-02-16T22:31:05Z,2016-02-17T22:32:51Z,2,1,1,0.5,1,1,0,1,{},0,1,{},"RPC/REST/ZMQ,TX fees and policy"
7547,3,3,3,2016-02-17T02:48:19Z,2016-02-17T08:40:32Z,1,0,1,1,0,2,1,2,{'LD2': 1},1,1,{'LD2': 1},
7554,2,2,2,2016-02-18T16:19:46Z,2016-02-18T16:28:49Z,1,0,1,1,0,1,0,2,{},0,1,{},
7571,1,1,1,2016-02-21T08:33:30Z,2016-02-21T10:38:20Z,1,0,1,1,0,1,1,0,{'LD2': 1},1,0,{'LD2': 1},
7572,3,3,3,2016-02-21T11:05:02Z,2016-02-21T18:52:25Z,1,0,1,1,0,3,0,3,{},0,3,{},
7580,4,4,4,2016-02-23T13:07:36Z,2016-02-23T14:20:19Z,1,0,1,1,0,3,1,3,{'LD3': 1},1,2,{'LD3': 1},Bug
7582,1,0.003802281,1,2016-02-23T16:36:46Z,2016-11-12T11:29:44Z,263,262,1,0.003802281,2,1,0,1,{},0,1,{},"GUI,Linux/Unix,Upstream"
7584,3,0.004037685,3,2016-02-23T21:52:04Z,2018-03-06T21:55:49Z,743,742,1,0.001345895,1,2,2,1,{'LD3': 2},1,1,{'LD3': 1},GUI
7587,2,0.1,2,2016-02-24T11:07:12Z,2016-03-14T14:31:47Z,20,19,1,0.05,1,1,1,1,{'LD1': 1},1,0,{'LD1': 1},Build system
7591,11,0.046218487,2.2,2016-02-24T17:18:36Z,2016-10-18T19:07:46Z,238,233,5,0.021008403,3,4,5,6,"{'LD6': 1, 'LD3': 2, 'LD4': 2}",2,2,"{'LD6': 1, 'LD3': 2, 'LD4': 1}",Validation
7593,4,0.063492063,1.333333333,2016-02-24T21:20:49Z,2016-04-27T15:27:22Z,63,60,3,0.047619048,3,4,2,2,"{'LD4': 1, 'LD3': 1}",2,2,"{'LD4': 1, 'LD3': 1}",Windows
7595,4,0.06557377,1.333333333,2016-02-25T01:10:06Z,2016-04-25T11:31:34Z,61,58,3,0.049180328,2,2,1,3,{'LD1': 1},1,1,{'LD1': 1},Build system
7596,5,0.006738544,1.666666667,2016-02-25T05:27:45Z,2018-03-07T19:28:08Z,742,739,3,0.004043127,3,4,0,5,{},0,4,{},"Bug,P2P"
7597,3,0.004048583,1.5,2016-02-25T08:41:47Z,2018-03-06T18:47:10Z,741,739,2,0.002699055,2,2,0,3,{},0,2,{},Wallet
7599,4,0.002622951,2,2016-02-25T17:59:44Z,2020-04-29T01:29:14Z,1525,1523,2,0.001311475,2,3,2,2,"{'LD3': 1, 'LD1': 1}",2,1,"{'LD3': 1, 'LD1': 1}",GUI
7611,1,0.333333333,1,2016-02-26T22:32:37Z,2016-02-29T09:08:14Z,3,2,1,0.333333333,1,1,0,1,{},0,1,{},RPC/REST/ZMQ
7626,5,0.025510204,1.666666667,2016-03-01T14:32:45Z,2016-09-13T08:38:26Z,196,193,3,0.015306122,2,3,0,5,{},0,3,{},"Build system,good first issue"
7627,3,0.066666667,1.5,2016-03-01T16:26:47Z,2016-04-15T06:58:42Z,45,43,2,0.044444444,1,2,0,3,{},0,2,{},Build system
7630,6,0.004788508,3,2016-03-02T02:15:03Z,2019-08-06T14:27:45Z,1253,1251,2,0.001596169,2,5,0,6,{},0,5,{},"Mempool,RPC/REST/ZMQ"
7633,30,0.026929982,2.5,2016-03-02T22:32:31Z,2019-03-21T20:23:54Z,1114,1102,12,0.010771993,8,13,12,18,"{'LD3': 4, 'LD4': 3, 'LD2': 2, 'LD1': 3}",8,5,"{'LD3': 3, 'LD4': 3, 'LD2': 2, 'LD1': 2}","Docs,Wallet"
7634,4,4,4,2016-03-03T06:37:34Z,2016-03-03T14:53:38Z,1,0,1,1,0,2,0,4,{},0,2,{},TX fees and policy
7638,3,3,3,2016-03-03T12:39:05Z,2016-03-03T13:02:58Z,1,0,1,1,0,2,1,2,{'LD2': 1},1,1,{'LD2': 1},
7639,2,0.181818182,2,2016-03-03T13:13:32Z,2016-03-14T10:41:03Z,11,10,1,0.090909091,1,2,1,1,{'LD4': 1},1,1,{'LD4': 1},"Bug,Windows"
7645,2,0.2,2,2016-03-04T20:59:33Z,2016-03-14T13:04:56Z,10,9,1,0.1,1,2,2,0,"{'LD2': 1, 'LD3': 1}",2,0,"{'LD2': 1, 'LD3': 1}",
7647,4,0.005471956,2,2016-03-06T14:02:46Z,2018-03-06T18:45:08Z,731,729,2,0.002735978,1,2,4,0,"{'LD3': 1, 'LD4': 2, 'LD5': 1}",2,0,"{'LD3': 1, 'LD4': 1, 'LD5': 1}",Wallet
7657,11,1.833333333,5.5,2016-03-09T05:05:12Z,2016-03-14T09:47:01Z,6,4,2,0.333333333,2,2,3,8,"{'LD4': 1, 'LD1': 2}",2,0,"{'LD4': 1, 'LD1': 2}",Wallet
7664,25,0.033647376,1.5625,2016-03-09T23:53:14Z,2018-03-22T18:55:22Z,743,727,16,0.02153432,13,9,8,17,"{'LD3': 2, 'LD4': 2, 'LD1': 1, 'LD2': 2, 'LD6': 1}",6,3,"{'LD3': 2, 'LD4': 2, 'LD1': 1, 'LD2': 1, 'LD6': 1}",Wallet
7672,4,0.036363636,1.333333333,2016-03-12T16:55:28Z,2016-06-30T00:50:59Z,110,107,3,0.027272727,2,3,2,2,"{'LD1': 1, 'LD3': 1}",2,1,"{'LD1': 1, 'LD3': 1}",GUI
7673,1,1,1,2016-03-13T08:40:28Z,2016-03-14T08:33:11Z,1,0,1,1,0,1,1,0,{'LD5': 1},1,0,{'LD5': 1},
7674,25,0.18115942,2.272727273,2016-03-13T11:08:51Z,2016-07-29T09:59:50Z,138,127,11,0.079710145,8,10,9,16,"{'LD4': 2, 'LD2': 2, 'LD1': 3, 'LD6': 2}",5,5,"{'LD4': 2, 'LD2': 2, 'LD1': 2, 'LD6': 2}",Windows
7675,5,0.004642526,1.25,2016-03-13T18:33:24Z,2019-02-23T03:16:08Z,1077,1073,4,0.00371402,4,4,0,5,{},0,4,{},"GUI,Privacy,Wallet"
7677,6,0.010989011,1.5,2016-03-14T10:07:45Z,2017-09-11T04:08:16Z,546,542,4,0.007326007,3,5,3,3,"{'LD4': 2, 'LD5': 1}",3,2,"{'LD4': 2, 'LD5': 1}","Brainstorming,Wallet"
7678,3,0.01986755,1,2016-03-14T10:44:37Z,2016-08-11T21:30:19Z,151,148,3,0.01986755,4,3,0,3,{},0,3,{},"Docs,good first issue"
7679,7,0.042682927,1.75,2016-03-14T11:29:56Z,2016-08-25T08:49:01Z,164,160,4,0.024390244,4,6,2,5,"{'LD2': 1, 'LD5': 1}",2,4,"{'LD2': 1, 'LD5': 1}",Docs
7681,4,0.038834951,1,2016-03-14T12:28:06Z,2016-06-25T10:59:36Z,103,99,4,0.038834951,4,4,2,2,{'LD3': 2},2,2,{'LD3': 2},Windows
7690,10,1.111111111,2.5,2016-03-15T01:14:51Z,2016-03-23T14:09:15Z,9,5,4,0.444444444,1,6,5,5,"{'LD4': 1, 'LD1': 2, 'LD5': 1, 'LD3': 1}",5,1,"{'LD4': 1, 'LD1': 2, 'LD5': 1, 'LD3': 1}",Wallet
7699,1,0.000666223,1,2016-03-17T05:46:01Z,2020-04-26T00:37:43Z,1501,1500,1,0.000666223,1,1,1,0,{'LD1': 1},1,0,{'LD1': 1},"Brainstorming,Wallet"
7700,2,2,2,2016-03-17T06:26:43Z,2016-03-17T11:35:02Z,1,0,1,1,0,1,1,1,{'LD3': 1},1,0,{'LD3': 1},P2P
7701,2,0.002777778,1,2016-03-17T09:41:28Z,2018-03-06T18:37:00Z,720,718,2,0.002777778,2,2,2,0,"{'LD4': 1, 'LD3': 1}",2,0,"{'LD4': 1, 'LD3': 1}",P2P
7704,5,0.020576132,1.25,2016-03-17T15:54:12Z,2016-11-14T20:44:28Z,243,239,4,0.016460905,3,2,1,4,{'LD5': 1},1,1,{'LD5': 1},"GUI,RPC/REST/ZMQ"
7714,5,0.3125,1.666666667,2016-03-18T10:33:54Z,2016-04-02T16:57:57Z,16,13,3,0.1875,2,4,1,4,{'LD1': 1},1,3,{'LD1': 1},"GUI,macOS"
7717,5,0.106382979,1.666666667,2016-03-18T20:14:47Z,2016-05-04T12:06:24Z,47,44,3,0.063829787,3,2,3,2,"{'LD4': 1, 'LD3': 2}",2,0,"{'LD4': 1, 'LD3': 2}","Scripts and tools,Tests"
7719,4,4,4,2016-03-19T12:37:49Z,2016-03-19T17:09:14Z,1,0,1,1,0,2,3,1,"{'LD4': 2, 'LD5': 1}",2,0,"{'LD4': 2, 'LD5': 1}",
7724,1,0.010638298,1,2016-03-20T18:02:51Z,2016-06-22T10:44:19Z,94,93,1,0.010638298,1,1,0,1,{},0,1,{},Windows
7725,4,0.042553191,1.333333333,2016-03-20T21:43:41Z,2016-06-22T10:50:51Z,94,91,3,0.031914894,3,4,3,1,"{'LD1': 2, 'LD4': 1}",3,1,"{'LD1': 2, 'LD4': 1}",Windows
7733,5,0.053763441,2.5,2016-03-22T08:33:34Z,2016-06-22T10:55:30Z,93,91,2,0.021505376,1,5,2,3,"{'LD1': 1, 'LD2': 1}",2,3,"{'LD1': 1, 'LD2': 1}","Docs,Feature"
7734,9,0.005603985,1.285714286,2016-03-22T16:42:29Z,2020-08-14T10:12:24Z,1606,1599,7,0.004358655,7,8,3,6,{'LD3': 3},3,5,{'LD3': 3},"Feature,GUI,Privacy"
7735,2,0.02173913,2,2016-03-23T01:04:02Z,2016-06-22T10:44:00Z,92,91,1,0.010869565,1,2,0,2,{},0,2,{},Brainstorming
7736,5,0.714285714,1.666666667,2016-03-23T05:04:37Z,2016-03-30T01:41:35Z,7,4,3,0.428571429,1,4,3,2,"{'LD1': 2, 'LD5': 1}",2,2,"{'LD1': 1, 'LD5': 1}",Wallet
7738,2,0.00280112,2,2016-03-23T13:33:01Z,2018-03-06T18:36:31Z,714,713,1,0.00140056,2,2,1,1,{'LD3': 1},1,1,{'LD3': 1},P2P
7745,4,1,2,2016-03-25T15:05:23Z,2016-03-29T07:33:25Z,4,2,2,0.5,1,2,0,4,{},0,2,{},"RPC/REST/ZMQ,Tests"
7746,2,2,2,2016-03-25T19:33:50Z,2016-03-25T20:15:16Z,1,0,1,1,0,2,1,1,{'LD4': 1},1,1,{'LD4': 1},
7750,6,6,6,2016-03-27T07:18:24Z,2016-03-27T12:03:57Z,1,0,1,1,0,2,1,5,{'LD1': 1},1,1,{'LD1': 1},
7752,3,0.034883721,1.5,2016-03-27T13:59:10Z,2016-06-21T08:58:36Z,86,84,2,0.023255814,1,3,2,1,{'LD3': 2},2,1,{'LD3': 2},GUI
7754,4,0.018181818,2,2016-03-28T10:30:24Z,2016-11-03T06:51:21Z,220,218,2,0.009090909,2,3,2,2,{'LD3': 2},2,1,{'LD3': 2},GUI
7758,3,0.002248876,3,2016-03-28T20:48:23Z,2019-11-22T20:03:13Z,1334,1333,1,0.000749625,1,2,0,3,{},0,2,{},RPC/REST/ZMQ
7760,4,0.006568144,1.333333333,2016-03-29T08:55:47Z,2017-11-28T07:30:54Z,609,606,3,0.004926108,1,3,1,3,{'LD3': 1},1,2,{'LD3': 1},"Feature,RPC/REST/ZMQ"
7765,3,0.015384615,1.5,2016-03-29T17:57:45Z,2016-10-10T09:57:48Z,195,193,2,0.01025641,2,3,2,1,"{'LD4': 1, 'LD6': 1}",2,1,"{'LD4': 1, 'LD6': 1}",macOS
7769,1,1,1,2016-03-30T03:08:12Z,2016-03-30T03:25:34Z,1,0,1,1,0,1,1,0,{'LD1': 1},1,0,{'LD1': 1},
7770,6,0.004021448,2,2016-03-30T10:23:21Z,2020-04-30T08:49:19Z,1492,1489,3,0.002010724,3,4,2,4,"{'LD3': 1, 'LD2': 1}",2,2,"{'LD3': 1, 'LD2': 1}","Build system,macOS"
7771,2,0.035087719,1,2016-03-30T14:10:03Z,2016-05-26T13:02:31Z,57,55,2,0.035087719,2,2,0,2,{},0,2,{},"RPC/REST/ZMQ,good first issue"
7782,3,3,3,2016-04-01T12:55:25Z,2016-04-01T22:40:19Z,1,0,1,1,0,1,1,2,{'LD4': 1},1,0,{'LD4': 1},
7790,2,2,2,2016-04-02T22:08:37Z,2016-04-03T10:03:28Z,1,0,1,1,0,2,2,0,{'LD4': 2},2,0,{'LD4': 2},GUI
7794,3,0.115384615,1.5,2016-04-03T10:35:49Z,2016-04-28T10:44:06Z,26,24,2,0.076923077,2,3,0,3,{},0,3,{},"RPC/REST/ZMQ,Wallet"
7799,1,1,1,2016-04-03T12:44:03Z,2016-04-03T12:53:36Z,1,0,1,1,0,1,1,0,{'LD3': 1},1,0,{'LD3': 1},Validation
7806,1,0.000673854,1,2016-04-04T10:10:59Z,2020-04-26T20:59:52Z,1484,1483,1,0.000673854,1,1,0,1,{},0,1,{},GUI
7808,2,2,2,2016-04-04T15:54:16Z,2016-04-04T17:29:42Z,1,0,1,1,0,2,1,1,{'LD1': 1},1,1,{'LD1': 1},
7834,11,0.074324324,5.5,2016-04-07T18:19:12Z,2016-09-02T11:44:10Z,148,146,2,0.013513514,2,5,3,8,{'LD3': 3},3,2,{'LD3': 3},"Build system,macOS"
7836,3,0.75,3,2016-04-07T22:48:50Z,2016-04-11T13:46:43Z,4,3,1,0.25,1,2,3,0,"{'LD5': 1, 'LD4': 2}",2,0,"{'LD5': 1, 'LD4': 1}",macOS
7837,1,0.142857143,1,2016-04-08T07:53:13Z,2016-04-14T14:10:27Z,7,6,1,0.142857143,1,1,1,0,{'LD4': 1},1,0,{'LD4': 1},"RPC/REST/ZMQ,good first issue"
7844,8,0.012345679,4,2016-04-08T20:16:13Z,2018-01-16T19:08:33Z,648,646,2,0.00308642,2,4,2,6,{'LD3': 2},2,2,{'LD3': 2},Tests
7845,1,0.166666667,1,2016-04-08T21:13:43Z,2016-04-14T11:39:36Z,6,5,1,0.166666667,1,1,0,1,{},0,1,{},macOS
7859,7,0.039106145,1.75,2016-04-11T14:06:51Z,2016-10-07T10:04:04Z,179,175,4,0.022346369,3,7,2,5,"{'LD3': 1, 'LD4': 1}",2,5,"{'LD3': 1, 'LD4': 1}",Tests
7860,7,1.75,3.5,2016-04-11T14:38:33Z,2016-04-15T09:05:26Z,4,2,2,0.5,1,4,3,4,"{'LD4': 1, 'LD1': 2}",2,2,"{'LD4': 1, 'LD1': 2}",
7869,1,1,1,2016-04-13T07:11:40Z,2016-04-13T07:24:17Z,1,0,1,1,0,1,0,1,{},0,1,{},"GUI,Windows"
7875,1,0.014285714,1,2016-04-14T07:26:27Z,2016-06-22T10:07:03Z,70,69,1,0.014285714,2,1,1,0,{'LD2': 1},1,0,{'LD2': 1},"Resource usage,Validation"
7879,7,0.005537975,1.4,2016-04-15T02:11:55Z,2019-09-30T20:12:46Z,1264,1259,5,0.003955696,4,4,5,2,"{'LD4': 2, 'LD1': 2, 'LD3': 1}",4,0,"{'LD4': 2, 'LD1': 2, 'LD3': 1}",RPC/REST/ZMQ
7883,7,0.010752688,1.75,2016-04-15T13:46:51Z,2018-01-26T13:46:28Z,651,647,4,0.006144393,4,4,2,5,"{'LD4': 1, 'LD6': 1}",2,2,"{'LD4': 1, 'LD6': 1}","Tests,good first issue"
7889,4,0.047619048,4,2016-04-16T08:51:27Z,2016-07-08T16:48:58Z,84,83,1,0.011904762,2,3,2,2,"{'LD6': 1, 'LD2': 1}",1,2,"{'LD6': 1, 'LD2': 1}",good first issue
7890,7,2.333333333,2.333333333,2016-04-16T10:46:30Z,2016-04-19T10:13:57Z,3,0,3,1,0,2,3,4,{'LD4': 3},1,1,{'LD4': 1},"Bug,RPC/REST/ZMQ"
7893,1,0.083333333,1,2016-04-16T14:57:41Z,2016-04-28T10:43:03Z,12,11,1,0.083333333,1,1,1,0,{'LD4': 1},1,0,{'LD4': 1},Tests
7895,4,0.014035088,2,2016-04-16T20:22:24Z,2017-01-26T09:43:51Z,285,283,2,0.007017544,2,4,1,3,{'LD3': 1},1,3,{'LD3': 1},Utils/log/libs
7901,3,0.006507592,1.5,2016-04-17T12:17:14Z,2017-07-22T09:32:28Z,461,459,2,0.004338395,2,3,0,3,{},0,3,{},good first issue
7902,17,1.0625,4.25,2016-04-17T19:44:22Z,2016-05-03T18:23:28Z,16,12,4,0.25,1,5,9,8,"{'LD4': 4, 'LD1': 4, 'LD5': 1}",4,1,"{'LD4': 3, 'LD1': 3, 'LD5': 1}",macOS
7908,1,1,1,2016-04-19T09:20:16Z,2016-04-19T09:30:08Z,1,0,1,1,0,1,0,1,{},0,1,{},
7909,1,1,1,2016-04-19T11:24:42Z,2016-04-19T12:49:23Z,1,0,1,1,0,1,0,1,{},0,1,{},
7924,1,0.2,1,2016-04-22T07:01:08Z,2016-04-26T11:31:18Z,5,4,1,0.2,2,1,1,0,{'LD5': 1},1,0,{'LD5': 1},Tests
7928,2,0.002453988,1,2016-04-23T08:05:59Z,2018-07-16T18:15:13Z,815,813,2,0.002453988,2,2,1,1,{'LD4': 1},1,1,{'LD4': 1},"GUI,Windows"
7929,1,0.5,1,2016-04-23T19:19:27Z,2016-04-25T10:57:08Z,2,1,1,0.5,1,1,0,1,{},0,1,{},Docs
7937,1,0.02,1,2016-04-25T13:49:01Z,2016-06-14T09:39:02Z,50,49,1,0.02,1,1,1,0,{'LD3': 1},1,0,{'LD3': 1},Build system
7943,5,0.038461538,5,2016-04-26T02:14:14Z,2016-09-02T11:41:19Z,130,129,1,0.007692308,1,3,2,3,"{'LD1': 1, 'LD2': 1}",2,1,"{'LD1': 1, 'LD2': 1}","RPC/REST/ZMQ,Windows"
7961,3,0.003690037,1,2016-04-27T20:38:23Z,2018-07-19T03:37:45Z,813,810,3,0.003690037,3,3,1,2,{'LD4': 1},1,2,{'LD4': 1},Build system
7965,13,0.014976959,1,2016-04-28T14:31:54Z,2018-09-13T13:51:06Z,868,855,13,0.014976959,12,4,4,9,"{'LD3': 2, 'LD1': 1, 'LD5': 1}",2,2,"{'LD3': 2, 'LD1': 1, 'LD5': 1}","Refactoring,Wallet"
7969,1,1,1,2016-04-29T00:43:04Z,2016-04-29T01:00:39Z,1,0,1,1,0,1,0,1,{},0,1,{},
7970,2,0.012121212,1,2016-04-29T07:09:44Z,2016-10-10T09:43:29Z,165,163,2,0.012121212,2,2,2,0,{'LD1': 2},2,0,{'LD1': 2},Windows
7978,1,0.001594896,1,2016-04-30T11:32:40Z,2018-01-16T19:11:12Z,627,626,1,0.001594896,1,1,0,1,{},0,1,{},"Mempool,Tests"
7979,3,0.056603774,1.5,2016-04-30T16:45:45Z,2016-06-22T10:44:31Z,53,51,2,0.037735849,1,3,1,2,{'LD4': 1},1,2,{'LD4': 1},Brainstorming
7981,6,0.035087719,2,2016-04-30T22:23:59Z,2016-10-18T19:07:13Z,171,168,3,0.01754386,2,5,2,4,"{'LD3': 1, 'LD1': 1}",2,3,"{'LD3': 1, 'LD1': 1}",Block storage
7987,2,0.25,2,2016-05-02T12:33:25Z,2016-05-10T10:52:43Z,8,7,1,0.125,1,1,2,0,{'LD1': 2},1,0,{'LD1': 1},Data corruption
7988,1,1,1,2016-05-02T13:43:28Z,2016-05-02T13:49:22Z,1,0,1,1,0,1,0,1,{},0,1,{},GUI
7990,1,0.001396648,1,2016-05-02T17:40:22Z,2018-04-18T09:53:10Z,716,715,1,0.001396648,1,1,0,1,{},0,1,{},Windows
7998,1,0.5,1,2016-05-04T02:06:49Z,2016-05-05T10:44:00Z,2,1,1,0.5,1,1,1,0,{'LD3': 1},1,0,{'LD3': 1},"Build system,macOS"
7999,2,0.04,2,2016-05-04T02:20:16Z,2016-06-22T10:32:09Z,50,49,1,0.02,1,2,1,1,{'LD3': 1},1,1,{'LD3': 1},GUI
8008,1,1,1,2016-05-05T15:29:35Z,2016-05-05T16:21:35Z,1,0,1,1,0,1,0,1,{},0,1,{},
8010,2,2,2,2016-05-05T18:49:02Z,2016-05-06T08:04:25Z,1,0,1,1,0,1,0,2,{},0,1,{},P2P
8017,6,0.009646302,2,2016-05-06T09:31:33Z,2018-01-17T11:28:14Z,622,619,3,0.004823151,3,2,3,3,"{'LD1': 2, 'LD4': 1}",2,0,"{'LD1': 1, 'LD4': 1}",Tests
8021,2,0.00137931,1,2016-05-08T03:18:01Z,2020-04-26T21:01:11Z,1450,1448,2,0.00137931,1,2,0,2,{},0,2,{},"Brainstorming,UTXO Db and Indexes"
8022,1,0.066666667,1,2016-05-08T04:11:49Z,2016-05-22T11:38:20Z,15,14,1,0.066666667,2,1,0,1,{},0,1,{},Tests
8024,2,2,2,2016-05-08T23:20:31Z,2016-05-09T00:04:44Z,1,0,1,1,0,1,0,2,{},0,1,{},
8027,1,0.027027027,1,2016-05-09T06:34:11Z,2016-06-14T09:38:23Z,37,36,1,0.027027027,1,1,1,0,{'LD1': 1},1,0,{'LD1': 1},"Block storage,Data corruption"
8032,1,0.058823529,1,2016-05-09T13:25:39Z,2016-05-26T05:24:50Z,17,16,1,0.058823529,1,1,1,0,{'LD3': 1},1,0,{'LD3': 1},"Docs,good first issue"
8040,2,0.142857143,1,2016-05-10T18:10:31Z,2016-05-23T19:50:00Z,14,12,2,0.142857143,1,2,2,0,"{'LD1': 1, 'LD6': 1}",2,0,"{'LD1': 1, 'LD6': 1}",macOS
8043,5,0.004230118,1.25,2016-05-11T20:00:10Z,2019-08-06T14:29:25Z,1182,1178,4,0.003384095,4,3,1,4,{'LD5': 1},1,2,{'LD5': 1},"GUI,Linux/Unix,Upstream"
8044,4,0.004188482,2,2016-05-11T20:17:01Z,2018-12-22T18:23:55Z,955,953,2,0.002094241,2,3,1,3,{'LD4': 1},1,2,{'LD4': 1},Block storage
8045,2,0.5,1,2016-05-12T00:07:29Z,2016-05-15T06:34:22Z,4,2,2,0.5,1,1,1,1,{'LD4': 1},1,0,{'LD4': 1},Tests
8060,5,0.037593985,1.25,2016-05-16T09:16:25Z,2016-09-25T17:59:29Z,133,129,4,0.030075188,2,3,2,3,"{'LD3': 1, 'LD4': 1}",2,1,"{'LD3': 1, 'LD4': 1}","GUI,good first issue"
8062,1,0.000894454,1,2016-05-17T01:20:57Z,2019-06-08T01:58:22Z,1118,1117,1,0.000894454,1,1,0,1,{},0,1,{},Mempool
8064,1,0.001302083,1,2016-05-17T05:57:25Z,2018-06-23T23:39:39Z,768,767,1,0.001302083,2,1,0,1,{},0,1,{},Feature
8069,3,1.5,3,2016-05-18T07:35:56Z,2016-05-19T07:58:41Z,2,1,1,0.5,1,1,1,2,{'LD3': 1},1,0,{'LD3': 1},Tests
8071,1,1,1,2016-05-19T07:53:43Z,2016-05-20T07:44:22Z,1,0,1,1,0,1,0,1,{},0,1,{},Tests
8074,1,0.005524862,1,2016-05-19T16:43:07Z,2016-11-16T13:21:45Z,181,180,1,0.005524862,1,1,1,0,{'LD2': 1},1,0,{'LD2': 1},Wallet
8079,25,0.373134328,1.785714286,2016-05-20T16:46:47Z,2016-07-26T09:27:53Z,67,53,14,0.208955224,7,11,6,19,"{'LD4': 5, 'LD3': 1}",4,7,"{'LD4': 3, 'LD3': 1}",Mempool
8081,7,7,7,2016-05-21T08:07:50Z,2016-05-21T13:15:08Z,1,0,1,1,0,3,2,5,"{'LD3': 1, 'LD5': 1}",1,2,"{'LD3': 1, 'LD5': 1}",
8089,2,0.002919708,1,2016-05-23T07:51:54Z,2018-04-07T16:49:28Z,685,683,2,0.002919708,2,2,0,2,{},0,2,{},Scripts and tools
8091,1,1,1,2016-05-23T23:57:34Z,2016-05-24T18:40:08Z,1,0,1,1,0,1,1,0,{'LD2': 1},1,0,{'LD2': 1},GUI
8093,1,1,1,2016-05-24T05:53:39Z,2016-05-24T18:38:14Z,1,0,1,1,0,1,0,1,{},0,1,{},
8096,5,0.009041591,1.666666667,2016-05-24T17:13:04Z,2017-11-28T02:21:25Z,553,550,3,0.005424955,2,4,1,4,{'LD4': 1},1,3,{'LD4': 1},Tests
8099,1,0.006024096,1,2016-05-25T15:31:51Z,2016-11-07T08:34:11Z,166,165,1,0.006024096,1,1,1,0,{'LD5': 1},1,0,{'LD5': 1},"Mempool,Resource usage,good first issue"
8100,1,0.5,1,2016-05-26T02:09:26Z,2016-05-27T04:38:32Z,2,1,1,0.5,1,1,0,1,{},0,1,{},
8103,3,3,3,2016-05-26T17:50:53Z,2016-05-27T06:26:28Z,1,0,1,1,0,2,1,2,{'LD3': 1},1,1,{'LD3': 1},"Tests,Upstream"
8105,15,0.089285714,1.666666667,2016-05-26T18:45:42Z,2016-11-09T21:42:07Z,168,159,9,0.053571429,6,5,3,12,"{'LD3': 2, 'LD5': 1}",3,2,"{'LD3': 2, 'LD5': 1}",good first issue
8114,1,1,1,2016-05-28T18:36:21Z,2016-05-28T18:45:10Z,1,0,1,1,0,1,1,0,{'LD1': 1},1,0,{'LD1': 1},
8117,4,0.059701493,1.333333333,2016-05-30T09:40:11Z,2016-08-04T10:33:55Z,67,64,3,0.044776119,3,2,2,2,{'LD4': 2},1,1,{'LD4': 1},"Docs,RPC/REST/ZMQ"
8120,14,0.064516129,2.8,2016-05-30T11:47:09Z,2017-01-02T08:43:43Z,217,212,5,0.023041475,6,7,6,8,"{'LD1': 1, 'LD6': 1, 'LD4': 1, 'LD3': 2, 'LD5': 1}",6,1,"{'LD1': 1, 'LD6': 1, 'LD4': 1, 'LD3': 2, 'LD5': 1}",macOS
8122,1,1,1,2016-05-30T13:22:32Z,2016-05-30T13:37:15Z,1,0,1,1,0,1,1,0,{'LD2': 1},1,0,{'LD2': 1},Tests
8124,5,0.227272727,2.5,2016-05-30T14:27:08Z,2016-06-21T09:08:19Z,22,20,2,0.090909091,1,3,1,4,{'LD3': 1},1,2,{'LD3': 1},"Feature,GUI"
8125,2,0.017699115,2,2016-05-30T14:31:38Z,2016-09-20T13:34:48Z,113,112,1,0.008849558,2,2,1,1,{'LD3': 1},1,1,{'LD3': 1},"GUI,good first issue"
8127,3,0.032258065,1.5,2016-05-30T16:46:48Z,2016-08-31T12:47:39Z,93,91,2,0.021505376,3,2,3,0,"{'LD3': 1, 'LD1': 2}",2,0,"{'LD3': 1, 'LD1': 2}","Build system,Upstream"
8130,4,0.030534351,1,2016-06-01T01:23:14Z,2016-10-09T12:48:19Z,131,127,4,0.030534351,5,3,2,2,"{'LD4': 1, 'LD5': 1}",2,1,"{'LD4': 1, 'LD5': 1}",Windows
8131,2,0.052631579,1,2016-06-01T06:06:05Z,2016-07-08T12:57:43Z,38,36,2,0.052631579,2,2,0,2,{},0,2,{},"Docs,good first issue"
8134,4,0.006163328,1,2016-06-02T07:48:55Z,2018-03-13T05:16:58Z,649,645,4,0.006163328,4,3,1,3,{'LD6': 1},1,2,{'LD6': 1},"Build system,macOS"
8145,3,0.6,1.5,2016-06-03T17:23:25Z,2016-06-08T14:42:41Z,5,3,2,0.4,2,3,1,2,{'LD3': 1},1,2,{'LD3': 1},Docs
8146,1,0.00621118,1,2016-06-04T18:33:56Z,2016-11-12T11:51:44Z,161,160,1,0.00621118,2,1,0,1,{},0,1,{},Data corruption
8150,3,3,3,2016-06-06T13:51:27Z,2016-06-07T06:59:00Z,1,0,1,1,0,3,0,3,{},0,3,{},Docs
8156,2,1,2,2016-06-07T03:00:32Z,2016-06-08T09:03:20Z,2,1,1,0.5,1,1,0,2,{},0,1,{},Docs
8157,2,2,2,2016-06-07T05:00:55Z,2016-06-07T05:46:47Z,1,0,1,1,0,2,1,1,{'LD3': 1},1,1,{'LD3': 1},
8160,3,0.003680982,1.5,2016-06-07T13:55:30Z,2018-08-31T11:06:20Z,815,813,2,0.002453988,3,2,1,2,{'LD6': 1},1,1,{'LD6': 1},"Docs,good first issue"
8162,1,0.166666667,1,2016-06-07T14:17:42Z,2016-06-13T05:58:22Z,6,5,1,0.166666667,1,1,1,0,{'LD3': 1},1,0,{'LD3': 1},Build system
8174,6,0.028846154,1.2,2016-06-08T14:16:00Z,2017-01-01T19:43:05Z,208,203,5,0.024038462,4,6,3,3,"{'LD3': 1, 'LD6': 1, 'LD5': 1}",3,3,"{'LD3': 1, 'LD6': 1, 'LD5': 1}","Block storage,Data corruption"
8183,9,0.011111111,2.25,2016-06-09T14:21:06Z,2018-08-27T19:48:56Z,810,806,4,0.004938272,4,7,2,7,"{'LD3': 1, 'LD4': 1}",2,5,"{'LD3': 1, 'LD4': 1}",Wallet
8190,2,2,2,2016-06-10T19:27:50Z,2016-06-11T15:40:28Z,1,0,1,1,0,2,1,1,{'LD1': 1},1,1,{'LD1': 1},
8196,7,0.011058452,2.333333333,2016-06-12T21:07:27Z,2018-03-06T21:59:41Z,633,630,3,0.004739336,2,3,3,4,{'LD4': 3},2,1,{'LD4': 2},Bug
8202,10,0.015847861,1.428571429,2016-06-14T15:54:56Z,2018-03-06T19:57:56Z,631,624,7,0.011093502,6,8,3,7,"{'LD1': 2, 'LD6': 1}",3,5,"{'LD1': 2, 'LD6': 1}","Feature,good first issue"
8211,5,0.014880952,1.666666667,2016-06-16T19:43:19Z,2017-05-18T12:45:32Z,336,333,3,0.008928571,3,2,3,2,"{'LD1': 2, 'LD3': 1}",1,1,"{'LD1': 1, 'LD3': 1}",RPC/REST/ZMQ
8212,2,0.090909091,2,2016-06-17T07:57:57Z,2016-07-08T10:03:00Z,22,21,1,0.045454545,1,1,0,2,{},0,1,{},Build system
8217,2,2,2,2016-06-18T08:13:27Z,2016-06-18T10:27:42Z,1,0,1,1,0,1,1,1,{'LD4': 1},1,0,{'LD4': 1},
8218,2,2,2,2016-06-18T10:08:59Z,2016-06-18T18:08:46Z,1,0,1,1,0,2,2,0,"{'LD4': 1, 'LD1': 1}",2,0,"{'LD4': 1, 'LD1': 1}",Wallet
8219,1,1,1,2016-06-18T16:17:31Z,2016-06-18T16:56:02Z,1,0,1,1,0,1,0,1,{},0,1,{},
8225,11,0.008301887,1.571428571,2016-06-19T16:33:11Z,2020-02-03T21:06:23Z,1325,1318,7,0.005283019,7,9,5,6,"{'LD4': 2, 'LD3': 1, 'LD6': 1, 'LD1': 1}",5,4,"{'LD4': 2, 'LD3': 1, 'LD6': 1, 'LD1': 1}","GUI,good first issue"
8228,2,0.105263158,1,2016-06-20T10:10:03Z,2016-07-08T13:09:19Z,19,17,2,0.105263158,2,1,1,1,{'LD1': 1},1,0,{'LD1': 1},"Build system,Docs"
8237,9,0.043478261,1.8,2016-06-22T07:38:31Z,2017-01-15T05:43:28Z,207,202,5,0.024154589,4,6,0,9,{},0,6,{},"GUI,Upstream"
8245,8,0.444444444,2,2016-06-23T10:33:15Z,2016-07-11T09:59:37Z,18,14,4,0.222222222,3,4,2,6,"{'LD1': 1, 'LD5': 1}",1,3,"{'LD1': 1, 'LD5': 1}",Validation
8248,5,0.003506311,1,2016-06-23T14:34:43Z,2020-05-19T12:02:37Z,1426,1421,5,0.003506311,6,4,1,4,{'LD1': 1},1,3,{'LD1': 1},Windows
8255,1,1,1,2016-06-24T08:17:26Z,2016-06-24T08:32:40Z,1,0,1,1,0,1,1,0,{'LD1': 1},1,0,{'LD1': 1},good first issue
8260,11,0.183333333,1.222222222,2016-06-25T05:25:18Z,2016-08-24T04:53:11Z,60,51,9,0.15,4,5,8,3,"{'LD4': 1, 'LD3': 4, 'LD1': 3}",3,2,"{'LD4': 1, 'LD3': 3, 'LD1': 2}",Build system
8263,11,0.014986376,1.222222222,2016-06-25T14:08:45Z,2018-06-28T19:16:44Z,734,725,9,0.01226158,7,6,1,10,{'LD4': 1},1,5,{'LD4': 1},"Build system,GUI"
8267,1,1,1,2016-06-26T02:15:12Z,2016-06-26T20:16:25Z,1,0,1,1,0,1,1,0,{'LD2': 1},1,0,{'LD2': 1},
8269,5,0.008077544,5,2016-06-26T13:35:29Z,2018-03-06T21:43:28Z,619,618,1,0.001615509,1,4,2,3,"{'LD1': 1, 'LD3': 1}",2,2,"{'LD1': 1, 'LD3': 1}",Build system
8276,1,1,1,2016-06-27T23:02:04Z,2016-06-28T05:40:41Z,1,0,1,1,0,1,1,0,{'LD1': 1},1,0,{'LD1': 1},
8279,9,0.039473684,1.285714286,2016-06-28T14:06:09Z,2017-02-11T11:35:40Z,228,221,7,0.030701754,8,4,5,4,"{'LD3': 1, 'LD1': 1, 'LD4': 1, 'LD2': 2}",3,1,"{'LD3': 1, 'LD1': 1, 'LD4': 1, 'LD2': 2}","Mempool,P2P"
8292,1,0.111111111,1,2016-06-29T23:36:43Z,2016-07-08T06:37:32Z,9,8,1,0.111111111,1,1,0,1,{},0,1,{},Build system
8294,4,0.181818182,2,2016-06-30T15:01:23Z,2016-07-21T16:19:17Z,22,20,2,0.090909091,2,3,1,3,{'LD4': 1},1,2,{'LD4': 1},Mining
8297,10,0.016556291,2,2016-06-30T19:55:18Z,2018-02-24T12:30:42Z,604,599,5,0.008278146,4,6,3,7,"{'LD4': 2, 'LD3': 1}",3,3,"{'LD4': 2, 'LD3': 1}",P2P
8299,1,0.2,1,2016-07-02T16:03:36Z,2016-07-07T10:02:33Z,5,4,1,0.2,1,1,0,1,{},0,1,{},
8300,10,2,3.333333333,2016-07-03T09:14:48Z,2016-07-08T06:30:17Z,5,2,3,0.6,1,4,6,4,"{'LD1': 2, 'LD3': 2, 'LD5': 2}",4,0,"{'LD1': 1, 'LD3': 2, 'LD5': 2}",Wallet
8301,2,2,2,2016-07-04T08:45:24Z,2016-07-04T09:01:57Z,1,0,1,1,0,2,1,1,{'LD2': 1},1,1,{'LD2': 1},GUI
8308,4,0.25,4,2016-07-06T18:11:54Z,2016-07-21T19:17:32Z,16,15,1,0.0625,1,3,1,3,{'LD3': 1},1,2,{'LD3': 1},"Docs,Wallet"
8322,2,0.666666667,2,2016-07-09T05:12:35Z,2016-07-11T10:45:13Z,3,2,1,0.333333333,1,2,0,2,{},0,2,{},Data corruption
8326,2,2,2,2016-07-10T05:34:27Z,2016-07-10T19:05:29Z,1,0,1,1,0,2,2,0,{'LD1': 2},2,0,{'LD1': 2},
8327,3,0.055555556,3,2016-07-10T16:04:10Z,2016-09-02T11:42:54Z,54,53,1,0.018518519,1,2,2,1,"{'LD4': 1, 'LD3': 1}",2,0,"{'LD4': 1, 'LD3': 1}",Build system
8333,5,0.004712535,1.25,2016-07-12T04:36:52Z,2019-06-08T01:59:25Z,1061,1057,4,0.003770028,4,5,2,3,{'LD1': 2},2,3,{'LD1': 2},"Resource usage,Validation"
8334,2,0.025641026,2,2016-07-12T08:43:44Z,2016-09-27T14:33:43Z,78,77,1,0.012820513,1,2,1,1,{'LD4': 1},1,1,{'LD4': 1},"Bug,TX fees and policy"
8338,1,0.003401361,1,2016-07-13T16:52:32Z,2017-05-03T16:06:19Z,294,293,1,0.003401361,1,1,0,1,{},0,1,{},Wallet
8350,3,0.025210084,1,2016-07-17T08:27:17Z,2016-11-12T12:53:30Z,119,116,3,0.025210084,2,2,1,2,{'LD4': 1},1,1,{'LD4': 1},"Refactoring,good first issue"
8368,7,0.036649215,2.333333333,2016-07-19T10:46:51Z,2017-01-26T09:40:57Z,191,188,3,0.015706806,3,3,2,5,"{'LD1': 1, 'LD4': 1}",2,1,"{'LD1': 1, 'LD4': 1}",Wallet
8383,7,0.875,2.333333333,2016-07-20T17:08:33Z,2016-07-28T11:14:39Z,8,5,3,0.375,2,4,3,4,"{'LD3': 2, 'LD4': 1}",2,2,"{'LD3': 2, 'LD4': 1}",Wallet
8395,8,0.102564103,2.666666667,2016-07-23T20:42:28Z,2016-10-09T12:56:36Z,78,75,3,0.038461538,4,5,5,3,"{'LD1': 4, 'LD4': 1}",4,1,"{'LD1': 3, 'LD4': 1}",Data corruption
8399,3,0.042253521,1.5,2016-07-24T22:07:18Z,2016-10-03T05:58:05Z,71,69,2,0.028169014,2,1,2,1,"{'LD4': 1, 'LD1': 1}",1,0,"{'LD4': 1, 'LD1': 1}","RPC/REST/ZMQ,good first issue"
8401,1,1,1,2016-07-24T23:20:03Z,2016-07-25T12:22:38Z,1,0,1,1,0,1,0,1,{},0,1,{},Wallet
8402,3,0.272727273,1,2016-07-25T01:11:25Z,2016-08-04T17:06:12Z,11,8,3,0.272727273,2,2,0,3,{},0,2,{},"Bug,Mining"
8404,7,3.5,3.5,2016-07-25T19:43:24Z,2016-07-27T15:52:40Z,2,0,2,1,0,3,4,3,"{'LD4': 1, 'LD1': 3}",2,1,"{'LD4': 1, 'LD1': 2}",Validation
8405,2,0.001805054,1,2016-07-26T08:43:38Z,2019-08-07T10:51:28Z,1108,1106,2,0.001805054,2,2,2,0,"{'LD1': 1, 'LD4': 1}",2,0,"{'LD1': 1, 'LD4': 1}",Wallet
8406,3,1.5,3,2016-07-26T09:33:57Z,2016-07-28T09:31:50Z,2,1,1,0.5,1,2,1,2,{'LD1': 1},1,1,{'LD1': 1},GUI
8409,1,1,1,2016-07-27T08:11:51Z,2016-07-28T02:54:45Z,1,0,1,1,0,1,1,0,{'LD1': 1},1,0,{'LD1': 1},P2P
8411,9,0.015306122,1.5,2016-07-27T15:52:17Z,2018-03-06T21:55:31Z,588,582,6,0.010204082,6,7,2,7,"{'LD4': 1, 'LD3': 1}",2,5,"{'LD4': 1, 'LD3': 1}","Bug,Windows"
8416,2,0.005102041,1,2016-07-28T10:59:45Z,2017-08-24T08:56:21Z,392,390,2,0.005102041,2,2,1,1,{'LD3': 1},1,1,{'LD3': 1},Wallet
8420,4,0.003108003,2,2016-07-28T19:39:02Z,2020-02-05T03:23:54Z,1287,1285,2,0.001554002,2,3,0,4,{},0,3,{},"GUI,macOS"
8425,8,0.034632035,1.6,2016-07-29T08:23:16Z,2017-03-16T10:02:58Z,231,226,5,0.021645022,4,3,3,5,"{'LD4': 1, 'LD1': 1, 'LD2': 1}",2,1,"{'LD4': 1, 'LD1': 1, 'LD2': 1}",Tests
8426,1,0.002293578,1,2016-07-29T11:14:13Z,2017-10-07T14:38:38Z,436,435,1,0.002293578,1,1,1,0,{'LD3': 1},1,0,{'LD3': 1},"Build system,Windows"
8429,2,0.004597701,1,2016-07-29T23:39:57Z,2017-10-07T09:13:25Z,435,433,2,0.004597701,3,2,0,2,{},0,2,{},Tests
8430,3,0.017964072,1,2016-07-30T00:29:22Z,2017-01-12T01:49:00Z,167,164,3,0.017964072,4,2,1,2,{'LD1': 1},1,1,{'LD1': 1},GUI
8431,4,0.006622517,1,2016-07-30T16:19:57Z,2018-03-26T12:44:32Z,604,600,4,0.006622517,4,3,3,1,"{'LD4': 1, 'LD1': 1, 'LD3': 1}",3,0,"{'LD4': 1, 'LD1': 1, 'LD3': 1}",GUI
8433,2,0.021052632,1,2016-07-31T05:52:13Z,2016-11-02T10:13:19Z,95,93,2,0.021052632,1,2,1,1,{'LD4': 1},1,1,{'LD4': 1},Mempool
8434,4,0.030534351,1.333333333,2016-07-31T06:53:28Z,2016-12-08T11:44:42Z,131,128,3,0.022900763,2,4,1,3,{'LD6': 1},1,3,{'LD6': 1},P2P
8455,31,0.149038462,2.583333333,2016-08-04T13:08:29Z,2017-02-28T12:48:24Z,208,196,12,0.057692308,11,8,0,31,{},0,8,{},Docs
8476,6,0.004376368,3,2016-08-06T18:44:27Z,2020-05-08T18:31:00Z,1371,1369,2,0.001458789,2,5,3,3,"{'LD1': 2, 'LD3': 1}",3,2,"{'LD1': 2, 'LD3': 1}","Block storage,P2P"
8479,3,0.428571429,1.5,2016-08-07T06:56:54Z,2016-08-13T10:53:27Z,7,5,2,0.285714286,3,2,1,2,{'LD2': 1},1,1,{'LD2': 1},Build system
8480,3,0.3,1,2016-08-07T10:20:48Z,2016-08-16T10:50:00Z,10,7,3,0.3,2,2,2,1,"{'LD3': 1, 'LD5': 1}",2,0,"{'LD3': 1, 'LD5': 1}",Consensus
8483,5,0.625,2.5,2016-08-07T22:32:26Z,2016-08-15T01:38:46Z,8,6,2,0.25,2,5,1,4,{'LD4': 1},1,4,{'LD4': 1},
8491,4,0.002947679,1.333333333,2016-08-09T03:22:58Z,2020-04-27T00:25:54Z,1357,1354,3,0.002210759,3,4,0,4,{},0,4,{},P2P
8496,4,0.666666667,1.333333333,2016-08-10T20:29:15Z,2016-08-16T09:22:09Z,6,3,3,0.5,2,4,3,1,"{'LD4': 1, 'LD6': 1, 'LD3': 1}",3,1,"{'LD4': 1, 'LD6': 1, 'LD3': 1}",RPC/REST/ZMQ
8500,7,3.5,7,2016-08-11T20:52:27Z,2016-08-13T13:22:06Z,2,1,1,0.5,1,4,4,3,"{'LD4': 1, 'LD1': 2, 'LD6': 1}",3,1,"{'LD4': 1, 'LD1': 2, 'LD6': 1}",
8508,4,0.666666667,2,2016-08-13T20:44:48Z,2016-08-19T17:04:04Z,6,4,2,0.333333333,1,3,2,2,"{'LD1': 1, 'LD3': 1}",2,1,"{'LD1': 1, 'LD3': 1}","GUI,good first issue"
8511,8,0.333333333,2,2016-08-14T08:05:48Z,2016-09-06T09:03:38Z,24,20,4,0.166666667,1,5,3,5,"{'LD3': 1, 'LD4': 2}",3,2,"{'LD3': 1, 'LD4': 2}","Build system,Windows"
8518,13,0.8125,3.25,2016-08-15T19:23:31Z,2016-08-31T16:00:37Z,16,12,4,0.25,3,5,4,9,"{'LD1': 2, 'LD3': 2}",4,1,"{'LD1': 2, 'LD3': 2}",P2P
8522,3,0.002222222,3,2016-08-16T12:29:59Z,2020-04-27T00:16:42Z,1350,1349,1,0.000740741,1,2,1,2,{'LD1': 1},1,1,{'LD1': 1},"Block storage,Data corruption,Windows"
8529,2,0.001481481,1,2016-08-16T23:29:09Z,2020-04-27T00:09:05Z,1350,1348,2,0.001481481,2,2,1,1,{'LD4': 1},1,1,{'LD4': 1},"Feature,Mempool"
8530,4,4,4,2016-08-17T09:02:33Z,2016-08-18T06:38:24Z,1,0,1,1,0,4,4,0,"{'LD3': 2, 'LD1': 1, 'LD4': 1}",4,0,"{'LD3': 2, 'LD1': 1, 'LD4': 1}","GUI,good first issue"
8532,5,0.192307692,2.5,2016-08-17T12:09:02Z,2016-09-11T18:13:53Z,26,24,2,0.076923077,2,3,1,4,{'LD3': 1},1,2,{'LD3': 1},Tests
8544,10,0.008396306,3.333333333,2016-08-19T08:54:12Z,2019-11-22T20:38:03Z,1191,1188,3,0.002518892,2,8,3,7,"{'LD4': 2, 'LD6': 1}",3,5,"{'LD4': 2, 'LD6': 1}",Wallet
8555,4,0.16,2,2016-08-20T15:03:36Z,2016-09-14T08:30:38Z,25,23,2,0.08,1,3,0,4,{},0,3,{},"Docs,good first issue"
8556,2,0.086956522,1,2016-08-21T00:14:35Z,2016-09-12T21:38:23Z,23,21,2,0.086956522,1,2,0,2,{},0,2,{},UTXO Db and Indexes
8562,1,1,1,2016-08-23T08:38:23Z,2016-08-23T08:43:48Z,1,0,1,1,0,1,1,0,{'LD3': 1},1,0,{'LD3': 1},
8569,4,0.036697248,1.333333333,2016-08-24T03:55:08Z,2016-12-10T06:49:30Z,109,106,3,0.027522936,2,2,2,2,"{'LD4': 1, 'LD3': 1}",1,1,"{'LD4': 1, 'LD3': 1}",P2P
8570,1,1,1,2016-08-24T05:03:13Z,2016-08-24T06:33:35Z,1,0,1,1,0,1,1,0,{'LD1': 1},1,0,{'LD1': 1},
8576,2,0.012903226,2,2016-08-24T10:37:46Z,2017-01-26T09:39:31Z,155,154,1,0.006451613,1,2,1,1,{'LD4': 1},1,1,{'LD4': 1},Docs
8577,8,0.125,1.6,2016-08-24T14:09:53Z,2016-10-27T06:12:27Z,64,59,5,0.078125,4,3,1,7,{'LD3': 1},1,2,{'LD3': 1},macOS
8584,2,1,2,2016-08-25T02:44:56Z,2016-08-26T05:58:44Z,2,1,1,0.5,1,2,2,0,"{'LD4': 1, 'LD3': 1}",2,0,"{'LD4': 1, 'LD3': 1}",
8586,3,3,3,2016-08-25T07:52:51Z,2016-08-25T08:29:20Z,1,0,1,1,0,2,2,1,"{'LD4': 1, 'LD1': 1}",1,1,"{'LD4': 1, 'LD1': 1}",GUI
8588,5,0.178571429,2.5,2016-08-25T08:24:19Z,2016-09-22T02:28:28Z,28,26,2,0.071428571,1,3,1,4,{'LD1': 1},1,2,{'LD1': 1},GUI
8599,2,0.153846154,2,2016-08-26T09:24:06Z,2016-09-07T11:10:43Z,13,12,1,0.076923077,1,1,1,1,{'LD1': 1},1,0,{'LD1': 1},P2P
8605,1,0.028571429,1,2016-08-26T15:06:25Z,2016-09-29T15:23:45Z,35,34,1,0.028571429,2,1,0,1,{},0,1,{},"Linux/Unix,Tests,macOS"
8609,3,0.214285714,3,2016-08-27T02:58:05Z,2016-09-09T08:54:38Z,14,13,1,0.071428571,1,3,2,1,{'LD4': 2},2,1,{'LD4': 2},
8614,4,0.024390244,2,2016-08-27T18:40:30Z,2017-02-07T12:41:26Z,164,162,2,0.012195122,1,3,2,2,{'LD3': 2},2,1,{'LD3': 2},"Block storage,RPC/REST/ZMQ"
8615,4,0.058823529,1,2016-08-27T19:06:28Z,2016-11-03T06:51:29Z,68,64,4,0.058823529,4,4,2,2,{'LD3': 2},2,2,{'LD3': 2},"GUI,Wallet"
8627,1,1,1,2016-08-30T10:47:19Z,2016-08-30T19:49:58Z,1,0,1,1,0,1,1,0,{'LD4': 1},1,0,{'LD4': 1},
8628,2,0.133333333,1,2016-08-30T12:48:04Z,2016-09-13T15:22:43Z,15,13,2,0.133333333,1,2,1,1,{'LD1': 1},1,1,{'LD1': 1},"GUI,Windows"
8630,1,0.5,1,2016-08-31T02:04:46Z,2016-09-01T13:31:57Z,2,1,1,0.5,1,1,1,0,{'LD1': 1},1,0,{'LD1': 1},Build system
8647,3,0.2,1,2016-09-02T00:42:37Z,2016-09-16T09:25:22Z,15,12,3,0.2,3,2,1,2,{'LD4': 1},1,1,{'LD4': 1},Tests
8649,2,0.105263158,1,2016-09-02T01:26:25Z,2016-09-20T09:30:45Z,19,17,2,0.105263158,3,2,0,2,{},0,2,{},Tests
8657,2,2,2,2016-09-02T19:02:36Z,2016-09-02T19:16:26Z,1,0,1,1,0,1,0,2,{},0,1,{},
8666,2,0.5,1,2016-09-05T10:46:54Z,2016-09-09T08:38:37Z,4,2,2,0.5,1,2,1,1,{'LD2': 1},1,1,{'LD2': 1},P2P
8668,2,0.001279591,1,2016-09-06T03:28:58Z,2020-12-16T16:45:09Z,1563,1561,2,0.001279591,1,2,1,1,{'LD5': 1},1,1,{'LD5': 1},Wallet
8669,1,0.009708738,1,2016-09-06T05:54:26Z,2016-12-17T09:24:19Z,103,102,1,0.009708738,2,1,0,1,{},0,1,{},Mempool
8684,3,0.5,3,2016-09-08T12:51:27Z,2016-09-13T12:52:53Z,6,5,1,0.166666667,1,2,1,2,{'LD1': 1},1,1,{'LD1': 1},Wallet
8689,7,0.012345679,3.5,2016-09-09T11:04:47Z,2018-03-30T06:33:42Z,567,565,2,0.003527337,2,4,4,3,{'LD3': 4},2,2,{'LD3': 2},Wallet
8691,3,0.5,1.5,2016-09-09T14:21:49Z,2016-09-15T10:58:47Z,6,4,2,0.333333333,3,2,1,2,{'LD1': 1},1,1,{'LD1': 1},"Build system,RPC/REST/ZMQ"
8698,1,0.000748503,1,2016-09-11T16:57:59Z,2020-05-08T18:31:32Z,1336,1335,1,0.000748503,2,1,0,1,{},0,1,{},RPC/REST/ZMQ
8705,1,1,1,2016-09-12T18:07:59Z,2016-09-12T21:55:10Z,1,0,1,1,0,1,0,1,{},0,1,{},Brainstorming
8706,2,0.666666667,1,2016-09-12T22:56:58Z,2016-09-15T04:59:03Z,3,1,2,0.666666667,1,2,1,1,{'LD4': 1},1,1,{'LD4': 1},Build system
8711,3,0.25,3,2016-09-13T13:47:40Z,2016-09-25T11:35:41Z,12,11,1,0.083333333,1,2,0,3,{},0,2,{},"Docs,good first issue"
8718,2,2,2,2016-09-13T23:28:01Z,2016-09-14T08:23:45Z,1,0,1,1,0,2,1,1,{'LD3': 1},1,1,{'LD3': 1},Refactoring
8719,2,0.011363636,1,2016-09-14T08:56:10Z,2017-03-08T14:31:42Z,176,174,2,0.011363636,1,2,0,2,{},0,2,{},good first issue
8721,1,1,1,2016-09-14T11:19:23Z,2016-09-14T14:17:01Z,1,0,1,1,0,1,0,1,{},0,1,{},
8732,12,0.017142857,1.333333333,2016-09-14T18:01:47Z,2018-08-15T14:31:23Z,700,691,9,0.012857143,10,8,8,4,"{'LD3': 3, 'LD4': 1, 'LD6': 2, 'LD1': 1, 'LD5': 1}",6,2,"{'LD3': 3, 'LD4': 1, 'LD6': 2, 'LD1': 1, 'LD5': 1}","Build system,Upstream,Windows"
8738,23,2.090909091,3.285714286,2016-09-15T11:09:57Z,2016-09-26T07:34:04Z,11,4,7,0.636363636,2,8,14,9,"{'LD3': 5, 'LD4': 4, 'LD1': 4, 'LD2': 1}",4,4,"{'LD3': 3, 'LD4': 4, 'LD1': 2, 'LD2': 1}",Resource usage
8741,5,0.454545455,1.666666667,2016-09-16T03:13:26Z,2016-09-27T01:54:37Z,11,8,3,0.272727273,2,2,2,3,"{'LD1': 1, 'LD5': 1}",2,0,"{'LD1': 1, 'LD5': 1}",macOS
8748,2,0.003731343,2,2016-09-16T23:33:54Z,2018-03-06T21:37:04Z,536,535,1,0.001865672,1,2,1,1,{'LD3': 1},1,1,{'LD3': 1},"Build system,macOS"
8749,2,2,2,2016-09-17T04:12:59Z,2016-09-17T07:45:00Z,1,0,1,1,0,1,1,1,{'LD4': 1},1,0,{'LD4': 1},
8752,5,0.004370629,1.666666667,2016-09-17T23:28:01Z,2019-11-05T08:56:23Z,1144,1141,3,0.002622378,4,4,2,3,"{'LD4': 1, 'LD3': 1}",2,2,"{'LD4': 1, 'LD3': 1}",RPC/REST/ZMQ
8758,10,0.020790021,1.666666667,2016-09-19T13:28:55Z,2018-01-13T01:13:58Z,481,475,6,0.012474012,4,5,3,7,"{'LD3': 1, 'LD5': 2}",3,2,"{'LD3': 1, 'LD5': 2}","Docs,good first issue"
8759,4,0.020408163,2,2016-09-19T13:34:20Z,2017-04-03T11:23:10Z,196,194,2,0.010204082,1,3,3,1,"{'LD3': 2, 'LD5': 1}",3,0,"{'LD3': 2, 'LD5': 1}",Build system
8761,2,1,2,2016-09-19T21:13:57Z,2016-09-21T09:05:08Z,2,1,1,0.5,1,2,1,1,{'LD3': 1},1,1,{'LD3': 1},Build system
8767,2,2,2,2016-09-20T15:05:43Z,2016-09-20T15:09:04Z,1,0,1,1,0,2,0,2,{},0,2,{},"GUI,Linux/Unix"
8770,3,0.037974684,3,2016-09-21T00:07:25Z,2016-12-08T11:49:02Z,79,78,1,0.012658228,1,2,2,1,{'LD4': 2},1,1,{'LD4': 1},RPC/REST/ZMQ
8778,2,2,2,2016-09-21T16:40:12Z,2016-09-21T22:52:07Z,1,0,1,1,0,2,2,0,{'LD1': 2},2,0,{'LD1': 2},Resource usage
8782,7,0.066666667,1.75,2016-09-21T21:50:32Z,2017-01-04T15:42:13Z,105,101,4,0.038095238,4,3,3,4,"{'LD4': 2, 'LD2': 1}",2,1,"{'LD4': 1, 'LD2': 1}",GUI
8797,2,0.0625,1,2016-09-22T19:46:57Z,2016-10-24T10:59:36Z,32,30,2,0.0625,3,2,1,1,{'LD3': 1},1,1,{'LD3': 1},P2P
8806,7,0.304347826,1.4,2016-09-25T10:14:33Z,2016-10-17T21:16:58Z,23,18,5,0.217391304,4,4,3,4,"{'LD4': 2, 'LD3': 1}",3,1,"{'LD4': 2, 'LD3': 1}","Upstream,Windows"
8812,3,1,1.5,2016-09-26T09:17:38Z,2016-09-29T07:48:07Z,3,1,2,0.666666667,1,2,1,2,{'LD6': 1},1,1,{'LD6': 1},macOS
8818,4,0.037037037,1.333333333,2016-09-27T02:01:41Z,2017-01-12T02:06:11Z,108,105,3,0.027777778,3,4,0,4,{},0,4,{},"Upstream,macOS"
8825,1,0.000765111,1,2016-09-28T03:31:10Z,2020-04-27T00:36:17Z,1307,1306,1,0.000765111,2,1,0,1,{},0,1,{},"Upstream,Windows"
8833,3,3,3,2016-09-28T20:13:49Z,2016-09-29T05:47:13Z,1,0,1,1,0,2,1,2,{'LD5': 1},1,1,{'LD5': 1},"Brainstorming,Tests"
8842,11,0.255813953,1.571428571,2016-09-29T18:46:36Z,2016-11-11T16:34:57Z,43,36,7,0.162790698,4,4,5,6,"{'LD6': 2, 'LD5': 2, 'LD3': 1}",4,0,"{'LD6': 1, 'LD5': 2, 'LD3': 1}",Tests
8847,2,0.046511628,1,2016-09-30T09:47:25Z,2016-11-11T10:03:39Z,43,41,2,0.046511628,2,2,1,1,{'LD3': 1},1,1,{'LD3': 1},macOS
8861,9,0.018672199,1.8,2016-10-01T22:58:34Z,2018-01-26T13:48:01Z,482,477,5,0.010373444,4,6,2,7,"{'LD1': 1, 'LD4': 1}",2,4,"{'LD1': 1, 'LD4': 1}",P2P
8864,2,0.052631579,1,2016-10-02T14:27:42Z,2016-11-09T10:05:36Z,38,36,2,0.052631579,2,2,2,0,{'LD3': 2},2,0,{'LD3': 2},"Feature,GUI,good first issue"
8867,2,0.018181818,1,2016-10-03T09:51:03Z,2017-01-21T00:51:46Z,110,108,2,0.018181818,2,2,0,2,{},0,2,{},"Build system,Upstream"
8868,9,1,4.5,2016-10-03T09:53:43Z,2016-10-11T14:00:46Z,9,7,2,0.222222222,1,4,5,4,"{'LD4': 2, 'LD3': 1, 'LD1': 1, 'LD2': 1}",3,1,"{'LD4': 2, 'LD3': 1, 'LD1': 1, 'LD2': 1}",Build system
8869,2,2,2,2016-10-03T10:21:30Z,2016-10-03T11:43:10Z,1,0,1,1,0,2,1,1,{'LD1': 1},1,1,{'LD1': 1},"Build system,macOS"
8875,15,0.009696186,1.666666667,2016-10-04T02:35:50Z,2020-12-28T05:35:21Z,1547,1538,9,0.005817712,6,7,4,11,"{'LD3': 2, 'LD1': 1, 'LD5': 1}",3,4,"{'LD3': 1, 'LD1': 1, 'LD5': 1}",Build system
8876,1,0.2,1,2016-10-04T04:21:05Z,2016-10-08T14:43:34Z,5,4,1,0.2,1,1,1,0,{'LD3': 1},1,0,{'LD3': 1},"Bug,GUI,P2P"
8878,3,1,3,2016-10-04T05:28:19Z,2016-10-06T07:28:09Z,3,2,1,0.333333333,1,3,2,1,{'LD2': 2},2,1,{'LD2': 2},Docs
8893,1,1,1,2016-10-05T10:49:53Z,2016-10-05T10:59:59Z,1,0,1,1,0,1,0,1,{},0,1,{},"Brainstorming,Consensus"
8900,8,1.333333333,2.666666667,2016-10-07T14:48:03Z,2016-10-13T09:51:55Z,6,3,3,0.5,2,4,3,5,"{'LD4': 1, 'LD5': 1, 'LD3': 1}",3,1,"{'LD4': 1, 'LD5': 1, 'LD3': 1}",GUI
8902,3,0.001923077,1,2016-10-09T03:54:58Z,2021-01-15T19:16:23Z,1560,1557,3,0.001923077,3,3,0,3,{},0,3,{},P2P
8907,3,1.5,1.5,2016-10-10T22:41:14Z,2016-10-12T20:51:19Z,2,0,2,1,0,3,2,1,"{'LD4': 1, 'LD5': 1}",2,1,"{'LD4': 1, 'LD5': 1}",Linux/Unix
8910,2,0.016666667,1,2016-10-11T10:59:51Z,2017-02-08T03:44:14Z,120,118,2,0.016666667,3,2,0,2,{},0,2,{},"Tests,Upstream"
8913,4,0.133333333,1,2016-10-12T11:39:11Z,2016-11-11T10:50:47Z,30,26,4,0.133333333,4,3,0,4,{},0,3,{},"Build system,macOS"
8917,1,1,1,2016-10-13T23:05:28Z,2016-10-13T23:29:02Z,1,0,1,1,0,1,0,1,{},0,1,{},
8919,2,0.005988024,1,2016-10-14T00:58:29Z,2017-09-12T09:47:44Z,334,332,2,0.005988024,1,2,0,2,{},0,2,{},P2P
8924,1,0.5,1,2016-10-15T12:57:12Z,2016-10-16T17:33:40Z,2,1,1,0.5,1,1,1,0,{'LD4': 1},1,0,{'LD4': 1},
8931,1,0.5,1,2016-10-16T05:28:07Z,2016-10-17T08:01:05Z,2,1,1,0.5,1,1,1,0,{'LD5': 1},1,0,{'LD5': 1},P2P
8933,2,0.005617978,2,2016-10-17T02:49:54Z,2017-10-07T09:11:14Z,356,355,1,0.002808989,1,1,1,1,{'LD2': 1},1,0,{'LD2': 1},P2P
8945,1,0.5,1,2016-10-17T20:53:59Z,2016-10-19T08:59:33Z,2,1,1,0.5,1,1,0,1,{},0,1,{},"Docs,RPC/REST/ZMQ,good first issue"
8953,5,0.011286682,2.5,2016-10-18T11:40:53Z,2018-01-04T08:23:43Z,443,441,2,0.004514673,2,3,2,3,{'LD5': 2},2,1,{'LD5': 2},"Tests,good first issue"
8956,8,0.006158584,2.666666667,2016-10-18T14:36:55Z,2020-05-08T18:34:31Z,1299,1296,3,0.002309469,2,5,2,6,"{'LD3': 1, 'LD1': 1}",2,3,"{'LD3': 1, 'LD1': 1}","Brainstorming,Consensus,Tests"
8967,5,5,5,2016-10-18T18:04:21Z,2016-10-19T15:27:07Z,1,0,1,1,0,3,4,1,"{'LD4': 1, 'LD3': 1, 'LD1': 2}",2,1,"{'LD4': 1, 'LD3': 1, 'LD1': 1}",Build system
8973,4,0.002768166,1.333333333,2016-10-19T10:40:29Z,2020-10-02T11:37:58Z,1445,1442,3,0.002076125,4,3,3,1,{'LD3': 3},3,0,{'LD3': 3},P2P
8978,1,1,1,2016-10-20T08:48:51Z,2016-10-20T08:52:50Z,1,0,1,1,0,1,0,1,{},0,1,{},Wallet
8979,5,0.357142857,1.666666667,2016-10-20T09:30:12Z,2016-11-03T06:51:33Z,14,11,3,0.214285714,3,4,0,5,{},0,4,{},"GUI,Wallet"
8984,1,1,1,2016-10-20T16:23:04Z,2016-10-21T12:30:25Z,1,0,1,1,0,1,1,0,{'LD3': 1},1,0,{'LD3': 1},GUI
8991,1,1,1,2016-10-21T12:58:37Z,2016-10-21T17:18:30Z,1,0,1,1,0,1,1,0,{'LD5': 1},1,0,{'LD5': 1},
9003,2,0.5,1,2016-10-24T07:10:41Z,2016-10-28T06:01:54Z,4,2,2,0.5,1,2,1,1,{'LD3': 1},1,1,{'LD3': 1},Linux/Unix
9006,1,0.5,1,2016-10-24T09:53:50Z,2016-10-25T11:14:52Z,2,1,1,0.5,1,1,1,0,{'LD1': 1},1,0,{'LD1': 1},"Build system,Docs,Upstream"
9007,2,2,2,2016-10-24T16:36:33Z,2016-10-25T10:37:22Z,1,0,1,1,0,2,1,1,{'LD1': 1},1,1,{'LD1': 1},P2P
9009,4,0.008032129,2,2016-10-25T08:20:15Z,2018-03-06T19:58:22Z,498,496,2,0.004016064,1,1,0,4,{},0,1,{},Linux/Unix
9024,2,0.071428571,2,2016-10-26T11:22:14Z,2016-11-23T06:14:37Z,28,27,1,0.035714286,1,2,2,0,"{'LD6': 1, 'LD4': 1}",2,0,"{'LD6': 1, 'LD4': 1}",RPC/REST/ZMQ
9028,3,0.007246377,1,2016-10-27T06:38:06Z,2017-12-14T20:19:22Z,414,411,3,0.007246377,3,1,2,1,"{'LD6': 1, 'LD5': 1}",1,0,"{'LD6': 1, 'LD5': 1}",Tests
9031,2,0.076923077,1,2016-10-27T10:49:28Z,2016-11-21T12:22:02Z,26,24,2,0.076923077,2,2,0,2,{},0,2,{},P2P
9034,3,0.027027027,1,2016-10-27T14:13:37Z,2017-02-15T10:14:18Z,111,108,3,0.027027027,3,2,1,2,{'LD2': 1},1,1,{'LD2': 1},Wallet
9035,1,0.0625,1,2016-10-28T05:37:15Z,2016-11-13T03:23:41Z,16,15,1,0.0625,1,1,0,1,{},0,1,{},"Build system,Upstream"
9038,7,1.166666667,2.333333333,2016-10-28T22:08:57Z,2016-11-03T09:50:37Z,6,3,3,0.5,1,5,3,4,"{'LD2': 1, 'LD3': 2}",3,2,"{'LD2': 1, 'LD3': 2}","GUI,Linux/Unix,Upstream"
9040,4,0.013888889,1.333333333,2016-10-29T11:20:45Z,2017-08-13T02:49:51Z,288,285,3,0.010416667,2,2,3,1,"{'LD4': 1, 'LD1': 2}",2,0,"{'LD4': 1, 'LD1': 2}",RPC/REST/ZMQ
9044,1,1,1,2016-10-30T19:20:12Z,2016-10-30T19:23:08Z,1,0,1,1,0,1,0,1,{},0,1,{},
9046,1,1,1,2016-10-31T08:15:10Z,2016-10-31T08:19:50Z,1,0,1,1,0,1,1,0,{'LD3': 1},1,0,{'LD3': 1},Build system
9047,6,0.6,3,2016-10-31T13:43:57Z,2016-11-09T21:00:52Z,10,8,2,0.2,2,5,3,3,"{'LD3': 2, 'LD1': 1}",2,3,"{'LD3': 1, 'LD1': 1}",
9051,17,0.055016181,2.125,2016-10-31T23:57:27Z,2017-09-05T13:15:04Z,309,301,8,0.025889968,4,7,4,13,"{'LD4': 1, 'LD5': 1, 'LD2': 1, 'LD3': 1}",3,4,"{'LD4': 1, 'LD5': 1, 'LD2': 1, 'LD3': 1}",Resource usage
9056,1,0.090909091,1,2016-11-01T08:20:52Z,2016-11-11T11:21:50Z,11,10,1,0.090909091,1,1,1,0,{'LD4': 1},1,0,{'LD4': 1},P2P
9057,2,0.181818182,2,2016-11-01T09:54:10Z,2016-11-11T11:14:12Z,11,10,1,0.090909091,1,2,1,1,{'LD1': 1},1,1,{'LD1': 1},Data corruption
9068,1,0.002949853,1,2016-11-02T20:12:21Z,2017-10-07T09:10:13Z,339,338,1,0.002949853,1,1,0,1,{},0,1,{},P2P
9078,8,1,2.666666667,2016-11-03T21:16:42Z,2016-11-11T09:02:06Z,8,5,3,0.375,2,3,2,6,"{'LD1': 1, 'LD4': 1}",2,1,"{'LD1': 1, 'LD4': 1}",Wallet
9079,2,0.4,2,2016-11-04T02:53:14Z,2016-11-08T10:05:33Z,5,4,1,0.2,1,1,0,2,{},0,1,{},"GUI,Wallet,good first issue"
9080,1,0.166666667,1,2016-11-04T03:01:15Z,2016-11-09T20:57:14Z,6,5,1,0.166666667,1,1,0,1,{},0,1,{},"Docs,P2P"
9086,2,2,2,2016-11-04T15:50:45Z,2016-11-04T18:03:56Z,1,0,1,1,0,2,2,0,{'LD4': 2},2,0,{'LD4': 2},Tests
9089,3,1,1.5,2016-11-05T11:33:05Z,2016-11-07T13:20:31Z,3,1,2,0.666666667,1,3,2,1,"{'LD1': 1, 'LD3': 1}",2,1,"{'LD1': 1, 'LD3': 1}","GUI,Windows"
9092,1,1,1,2016-11-06T22:39:50Z,2016-11-07T00:57:05Z,1,0,1,1,0,1,1,0,{'LD3': 1},1,0,{'LD3': 1},
9099,2,2,2,2016-11-07T23:05:56Z,2016-11-08T01:06:05Z,1,0,1,1,0,1,0,2,{},0,1,{},Linux/Unix
9103,3,0.005434783,1,2016-11-08T19:17:44Z,2018-05-14T12:36:07Z,552,549,3,0.005434783,3,3,0,3,{},0,3,{},"Mempool,TX fees and policy"
9105,5,2.5,5,2016-11-08T20:25:32Z,2016-11-09T20:53:24Z,2,1,1,0.5,1,2,3,2,"{'LD1': 2, 'LD4': 1}",2,0,"{'LD1': 2, 'LD4': 1}","Build system,Questions and Help"
9106,5,0.016611296,1.25,2016-11-08T20:46:40Z,2017-09-05T18:25:45Z,301,297,4,0.013289037,2,3,1,4,{'LD1': 1},1,2,{'LD1': 1},TX fees and policy
9110,2,0.666666667,2,2016-11-09T08:41:28Z,2016-11-11T09:59:19Z,3,2,1,0.333333333,1,2,2,0,"{'LD3': 1, 'LD4': 1}",2,0,"{'LD3': 1, 'LD4': 1}","Docs,P2P"
9119,4,0.333333333,1.333333333,2016-11-09T21:19:19Z,2016-11-21T09:23:12Z,12,9,3,0.25,2,3,3,1,"{'LD1': 2, 'LD5': 1}",3,0,"{'LD1': 2, 'LD5': 1}","Data corruption,Questions and Help"
9126,3,0.038961039,1.5,2016-11-11T05:30:41Z,2017-01-26T09:31:23Z,77,75,2,0.025974026,2,1,2,1,"{'LD4': 1, 'LD1': 1}",1,0,"{'LD4': 1, 'LD1': 1}","Build system,macOS"
9127,2,0.010471204,1,2016-11-11T05:41:53Z,2017-05-20T11:06:09Z,191,189,2,0.010471204,2,2,2,0,"{'LD2': 1, 'LD1': 1}",2,0,"{'LD2': 1, 'LD1': 1}",macOS
9134,2,1,2,2016-11-11T18:38:18Z,2016-11-13T17:37:18Z,2,1,1,0.5,1,1,1,1,{'LD3': 1},1,0,{'LD3': 1},Build system
9135,3,0.002354788,1,2016-11-11T21:08:29Z,2020-05-08T18:35:46Z,1274,1271,3,0.002354788,3,2,2,1,"{'LD1': 1, 'LD4': 1}",2,0,"{'LD1': 1, 'LD4': 1}",Wallet
9146,1,1,1,2016-11-12T14:42:47Z,2016-11-12T14:46:38Z,1,0,1,1,0,1,0,1,{},0,1,{},
9147,1,1,1,2016-11-12T15:08:26Z,2016-11-12T15:28:43Z,1,0,1,1,0,1,0,1,{},0,1,{},
9148,3,0.041666667,3,2016-11-12T22:20:55Z,2017-01-23T16:23:03Z,72,71,1,0.013888889,1,2,1,2,{'LD4': 1},1,1,{'LD4': 1},"Brainstorming,Wallet"
9149,1,1,1,2016-11-13T02:58:22Z,2016-11-13T09:23:09Z,1,0,1,1,0,1,1,0,{'LD2': 1},1,0,{'LD2': 1},
9153,2,2,2,2016-11-13T22:09:59Z,2016-11-13T22:55:17Z,1,0,1,1,0,2,2,0,{'LD2': 2},2,0,{'LD2': 2},
9157,1,1,1,2016-11-14T16:33:56Z,2016-11-15T07:35:47Z,1,0,1,1,0,1,0,1,{},0,1,{},
9163,2,0.125,1,2016-11-15T12:59:52Z,2016-11-30T16:51:49Z,16,14,2,0.125,2,2,2,0,"{'LD4': 1, 'LD3': 1}",2,0,"{'LD4': 1, 'LD3': 1}",P2P
9166,8,0.006354249,2,2016-11-15T18:11:22Z,2020-04-26T21:15:57Z,1259,1255,4,0.003177125,2,4,5,3,"{'LD1': 2, 'LD2': 1, 'LD3': 1, 'LD5': 1}",3,1,"{'LD1': 1, 'LD2': 1, 'LD3': 1, 'LD5': 1}",RPC/REST/ZMQ
9170,3,0.02238806,1.5,2016-11-16T08:51:44Z,2017-03-30T08:08:10Z,134,132,2,0.014925373,2,3,2,1,"{'LD2': 1, 'LD4': 1}",2,1,"{'LD2': 1, 'LD4': 1}",macOS
9182,1,0.033333333,1,2016-11-18T02:40:07Z,2016-12-17T11:29:40Z,30,29,1,0.033333333,1,1,1,0,{'LD5': 1},1,0,{'LD5': 1},P2P
9184,2,0.00330033,2,2016-11-18T04:09:38Z,2018-07-16T18:41:31Z,606,605,1,0.001650165,2,1,2,0,{'LD4': 2},1,0,{'LD4': 1},RPC/REST/ZMQ
9187,2,0.090909091,1,2016-11-18T15:21:01Z,2016-12-10T08:10:34Z,22,20,2,0.090909091,2,2,1,1,{'LD1': 1},1,1,{'LD1': 1},"Data corruption,Windows"
9192,1,0.000777605,1,2016-11-20T10:31:37Z,2020-05-29T08:29:26Z,1286,1285,1,0.000777605,1,1,1,0,{'LD3': 1},1,0,{'LD3': 1},GUI
9195,4,0.010989011,1.333333333,2016-11-21T09:39:00Z,2017-11-19T13:16:14Z,364,361,3,0.008241758,2,3,2,2,"{'LD3': 1, 'LD5': 1}",2,1,"{'LD3': 1, 'LD5': 1}","GUI,good first issue"
9198,1,0.000914913,1,2016-11-22T02:30:54Z,2019-11-19T11:27:32Z,1093,1092,1,0.000914913,1,1,0,1,{},0,1,{},Bug
9209,1,1,1,2016-11-23T10:46:25Z,2016-11-23T19:44:27Z,1,0,1,1,0,1,0,1,{},0,1,{},Build system
9210,1,0.038461538,1,2016-11-23T11:08:03Z,2016-12-19T08:08:40Z,26,25,1,0.038461538,2,1,0,1,{},0,1,{},GUI
9212,6,0.082191781,2,2016-11-23T13:40:18Z,2017-02-04T10:38:28Z,73,70,3,0.04109589,3,5,3,3,"{'LD2': 2, 'LD3': 1}",3,2,"{'LD2': 2, 'LD3': 1}","Bug,P2P"
9214,11,0.007751938,1.222222222,2016-11-24T00:25:22Z,2020-10-12T12:23:34Z,1419,1410,9,0.006342495,7,6,4,7,"{'LD4': 2, 'LD3': 1, 'LD5': 1}",4,2,"{'LD4': 2, 'LD3': 1, 'LD5': 1}","P2P,Upstream"
9215,6,0.006085193,2,2016-11-24T10:31:24Z,2019-08-07T00:08:59Z,986,983,3,0.003042596,2,5,2,4,{'LD4': 2},2,3,{'LD4': 2},P2P
9217,2,2,2,2016-11-24T12:57:56Z,2016-11-25T08:30:40Z,1,0,1,1,0,2,1,1,{'LD1': 1},1,1,{'LD1': 1},Questions and Help
9228,2,1,2,2016-11-27T05:40:56Z,2016-11-28T08:02:13Z,2,1,1,0.5,1,2,1,1,{'LD1': 1},1,1,{'LD1': 1},macOS
9231,6,2,2,2016-11-28T04:23:20Z,2016-11-30T11:31:53Z,3,0,3,1,0,5,3,3,"{'LD4': 1, 'LD2': 1, 'LD1': 1}",2,3,"{'LD4': 1, 'LD2': 1, 'LD1': 1}","Build system,Upstream"
9232,5,0.012722646,5,2016-11-28T08:22:35Z,2017-12-25T15:23:07Z,393,392,1,0.002544529,1,3,2,3,"{'LD4': 1, 'LD1': 1}",2,1,"{'LD4': 1, 'LD1': 1}",Docs
9247,1,1,1,2016-11-30T09:42:05Z,2016-11-30T09:44:59Z,1,0,1,1,0,1,0,1,{},0,1,{},Tests
9248,1,0.001814882,1,2016-11-30T13:37:19Z,2018-06-04T13:31:25Z,551,550,1,0.001814882,2,1,0,1,{},0,1,{},
9250,1,0.125,1,2016-11-30T15:53:53Z,2016-12-08T07:25:20Z,8,7,1,0.125,2,1,0,1,{},0,1,{},GUI
9258,1,1,1,2016-12-01T19:07:27Z,2016-12-01T20:01:34Z,1,0,1,1,0,1,1,0,{'LD2': 1},1,0,{'LD2': 1},
9272,3,0.003033367,1.5,2016-12-04T06:12:14Z,2019-08-19T09:14:39Z,989,987,2,0.002022245,3,2,2,1,"{'LD1': 1, 'LD3': 1}",2,0,"{'LD1': 1, 'LD3': 1}",RPC/REST/ZMQ
9278,4,0.016194332,1.333333333,2016-12-05T05:11:19Z,2017-08-09T02:16:33Z,247,244,3,0.012145749,2,3,1,3,{'LD4': 1},1,2,{'LD4': 1},Tests
9287,3,3,3,2016-12-06T01:22:18Z,2016-12-06T12:33:17Z,1,0,1,1,0,1,3,0,"{'LD1': 1, 'LD4': 1, 'LD5': 1}",1,0,"{'LD1': 1, 'LD4': 1, 'LD5': 1}",Questions and Help
9301,1,0.006097561,1,2016-12-08T11:23:10Z,2017-05-21T05:57:50Z,164,163,1,0.006097561,1,1,0,1,{},0,1,{},Build system
9314,1,0.003311258,1,2016-12-10T06:56:12Z,2017-10-07T14:36:43Z,302,301,1,0.003311258,2,1,0,1,{},0,1,{},P2P
9317,5,0.032051282,1,2016-12-10T21:55:22Z,2017-05-15T14:10:33Z,156,151,5,0.032051282,3,3,4,1,"{'LD1': 3, 'LD4': 1}",2,1,"{'LD1': 2, 'LD4': 1}",Tests
9320,1,1,1,2016-12-11T10:58:30Z,2016-12-11T11:07:51Z,1,0,1,1,0,1,0,1,{},0,1,{},
9321,1,0.016949153,1,2016-12-11T11:36:08Z,2017-02-07T12:30:59Z,59,58,1,0.016949153,1,1,0,1,{},0,1,{},"Questions and Help,Resource usage"
9328,2,0.001623377,1,2016-12-12T08:28:07Z,2020-04-27T00:24:53Z,1232,1230,2,0.001623377,2,2,1,1,{'LD4': 1},1,1,{'LD4': 1},"Brainstorming,TX fees and policy"
9341,2,1,2,2016-12-13T15:25:58Z,2016-12-15T00:36:19Z,2,1,1,0.5,1,1,2,0,"{'LD1': 1, 'LD2': 1}",1,0,"{'LD1': 1, 'LD2': 1}","Questions and Help,Windows"
9348,1,1,1,2016-12-14T16:36:55Z,2016-12-14T16:41:56Z,1,0,1,1,0,1,0,1,{},0,1,{},P2P
9356,3,1,3,2016-12-15T19:12:20Z,2016-12-18T14:08:02Z,3,2,1,0.333333333,1,2,1,2,{'LD1': 1},1,1,{'LD1': 1},Windows
9374,9,0.017751479,4.5,2016-12-19T03:30:33Z,2018-05-09T14:37:17Z,507,505,2,0.003944773,1,5,1,8,{'LD3': 1},1,4,{'LD3': 1},Feature
9386,5,5,5,2016-12-20T01:58:02Z,2016-12-20T11:19:59Z,1,0,1,1,0,4,1,4,{'LD1': 1},1,3,{'LD1': 1},Upstream
9394,2,2,2,2016-12-21T00:59:09Z,2016-12-21T10:22:47Z,1,0,1,1,0,2,1,1,{'LD3': 1},1,1,{'LD3': 1},Tests
9398,5,0.263157895,1.666666667,2016-12-21T06:46:19Z,2017-01-09T06:43:42Z,19,16,3,0.157894737,1,3,4,1,"{'LD1': 1, 'LD3': 1, 'LD4': 1, 'LD5': 1}",2,1,"{'LD1': 1, 'LD3': 1, 'LD4': 1, 'LD5': 1}","Mempool,Resource usage"
9410,3,0.214285714,1.5,2016-12-22T22:07:51Z,2017-01-05T20:00:51Z,14,12,2,0.142857143,2,3,1,2,{'LD4': 1},1,2,{'LD4': 1},"GUI,Wallet"
9423,4,0.013986014,2,2016-12-25T16:33:56Z,2017-10-07T09:07:46Z,286,284,2,0.006993007,3,3,0,4,{},0,3,{},Utils/log/libs
9425,2,0.001626016,2,2016-12-26T07:41:24Z,2020-05-08T19:20:50Z,1230,1229,1,0.000813008,1,2,0,2,{},0,2,{},Wallet
9426,1,0.000821018,1,2016-12-26T07:49:32Z,2020-04-26T22:22:38Z,1218,1217,1,0.000821018,2,1,0,1,{},0,1,{},"Brainstorming,RPC/REST/ZMQ"
9429,1,1,1,2016-12-26T12:02:25Z,2016-12-26T14:30:55Z,1,0,1,1,0,1,0,1,{},0,1,{},Wallet
9430,6,0.133333333,1.5,2016-12-26T12:19:40Z,2017-02-09T08:14:22Z,45,41,4,0.088888889,4,3,3,3,"{'LD1': 1, 'LD4': 1, 'LD3': 1}",2,1,"{'LD1': 1, 'LD4': 1, 'LD3': 1}",Linux/Unix
9431,3,0.428571429,1.5,2016-12-26T17:21:07Z,2017-01-02T17:18:34Z,7,5,2,0.285714286,1,2,3,0,"{'LD4': 1, 'LD3': 2}",2,0,"{'LD4': 1, 'LD3': 2}",Windows
9432,1,0.125,1,2016-12-26T18:22:41Z,2017-01-03T08:30:33Z,8,7,1,0.125,1,1,0,1,{},0,1,{},Windows
9434,5,1.666666667,5,2016-12-27T00:06:23Z,2016-12-29T21:23:48Z,3,2,1,0.333333333,1,3,2,3,"{'LD4': 1, 'LD1': 1}",1,2,"{'LD4': 1, 'LD1': 1}",Linux/Unix
9437,2,0.004608295,1,2016-12-28T07:40:09Z,2018-03-06T21:59:15Z,434,432,2,0.004608295,2,2,2,0,"{'LD3': 1, 'LD5': 1}",2,0,"{'LD3': 1, 'LD5': 1}",
9439,1,0.006993007,1,2016-12-29T04:44:28Z,2017-05-20T14:38:52Z,143,142,1,0.006993007,2,1,0,1,{},0,1,{},macOS
9449,2,2,2,2016-12-30T17:44:24Z,2016-12-30T22:16:51Z,1,0,1,1,0,2,1,1,{'LD4': 1},1,1,{'LD4': 1},
9454,4,2,4,2017-01-01T20:13:36Z,2017-01-03T07:58:04Z,2,1,1,0.5,1,4,0,4,{},0,4,{},"Utils/log/libs,Windows"
9455,5,0.011655012,1.25,2017-01-02T08:42:33Z,2018-03-06T21:37:26Z,429,425,4,0.009324009,4,4,2,3,"{'LD4': 1, 'LD1': 1}",2,2,"{'LD4': 1, 'LD1': 1}",TX fees and policy
9456,4,2,2,2017-01-02T09:19:39Z,2017-01-04T01:47:43Z,2,0,2,1,0,3,4,0,"{'LD4': 2, 'LD2': 1, 'LD3': 1}",3,0,"{'LD4': 2, 'LD2': 1, 'LD3': 1}","Questions and Help,Wallet"
9458,3,3,3,2017-01-02T18:33:07Z,2017-01-03T07:38:17Z,1,0,1,1,0,3,2,1,"{'LD4': 1, 'LD1': 1}",2,1,"{'LD4': 1, 'LD1': 1}",Questions and Help
9463,8,0.012820513,2.666666667,2017-01-03T17:38:05Z,2018-09-19T00:36:12Z,624,621,3,0.004807692,2,5,2,6,{'LD3': 2},2,3,{'LD3': 2},RPC/REST/ZMQ
9464,4,0.003030303,1.333333333,2017-01-03T23:26:28Z,2020-08-15T04:39:24Z,1320,1317,3,0.002272727,3,3,3,1,{'LD3': 3},3,0,{'LD3': 3},"Bug,GUI"
9466,2,0.333333333,2,2017-01-04T09:03:14Z,2017-01-09T16:38:03Z,6,5,1,0.166666667,1,2,0,2,{},0,2,{},"Bug,TX fees and policy"
9482,7,0.005742412,2.333333333,2017-01-06T15:30:56Z,2020-05-09T12:56:48Z,1219,1216,3,0.002461034,2,5,2,5,"{'LD2': 1, 'LD4': 1}",2,3,"{'LD2': 1, 'LD4': 1}",Block storage
9491,14,0.368421053,3.5,2017-01-08T08:09:11Z,2017-02-14T13:32:53Z,38,34,4,0.105263158,4,7,2,12,"{'LD1': 1, 'LD4': 1}",2,5,"{'LD1': 1, 'LD4': 1}","Bug,RPC/REST/ZMQ,Wallet"
9501,1,0.083333333,1,2017-01-10T02:32:55Z,2017-01-21T10:54:32Z,12,11,1,0.083333333,2,1,1,0,{'LD3': 1},1,0,{'LD3': 1},P2P
9515,1,1,1,2017-01-11T02:14:09Z,2017-01-11T17:49:00Z,1,0,1,1,0,1,1,0,{'LD1': 1},1,0,{'LD1': 1},
9521,1,1,1,2017-01-12T01:16:58Z,2017-01-12T20:42:48Z,1,0,1,1,0,1,1,0,{'LD1': 1},1,0,{'LD1': 1},macOS
9523,1,1,1,2017-01-12T03:54:50Z,2017-01-12T05:53:13Z,1,0,1,1,0,1,0,1,{},0,1,{},
9540,4,0.004347826,1.333333333,2017-01-13T04:43:09Z,2019-07-21T14:25:11Z,920,917,3,0.00326087,3,3,2,2,"{'LD3': 1, 'LD4': 1}",2,1,"{'LD3': 1, 'LD4': 1}",P2P
9541,2,2,2,2017-01-13T05:29:50Z,2017-01-13T07:42:19Z,1,0,1,1,0,2,1,1,{'LD1': 1},1,1,{'LD1': 1},"Questions and Help,macOS"
9546,3,0.12,3,2017-01-13T20:01:36Z,2017-02-07T12:28:21Z,25,24,1,0.04,1,3,2,1,"{'LD2': 1, 'LD3': 1}",2,1,"{'LD2': 1, 'LD3': 1}",Questions and Help
9562,2,0.003738318,1,2017-01-15T13:13:00Z,2018-07-04T04:11:23Z,535,533,2,0.003738318,3,2,0,2,{},0,2,{},P2P
9563,5,0.012019231,1.666666667,2017-01-15T13:41:53Z,2018-03-06T22:20:41Z,416,413,3,0.007211538,2,4,3,2,"{'LD3': 1, 'LD4': 1, 'LD2': 1}",3,1,"{'LD3': 1, 'LD4': 1, 'LD2': 1}",Windows
9564,9,0.007512521,1.8,2017-01-15T20:55:46Z,2020-04-27T00:24:10Z,1198,1193,5,0.004173623,4,5,3,6,"{'LD2': 1, 'LD1': 1, 'LD4': 1}",3,2,"{'LD2': 1, 'LD1': 1, 'LD4': 1}","RPC/REST/ZMQ,Wallet,good first issue"
9565,1,1,1,2017-01-16T18:29:06Z,2017-01-17T09:38:03Z,1,0,1,1,0,1,0,1,{},0,1,{},"RPC/REST/ZMQ,Windows"
9573,4,0.008908686,1.333333333,2017-01-18T08:09:12Z,2018-04-12T02:26:52Z,449,446,3,0.006681514,2,4,2,2,"{'LD2': 1, 'LD4': 1}",2,2,"{'LD2': 1, 'LD4': 1}",Tests
9584,4,0.002734108,1.333333333,2017-01-19T16:28:16Z,2021-01-20T22:33:14Z,1463,1460,3,0.002050581,3,3,3,1,{'LD2': 3},3,0,{'LD2': 3},Wallet
9585,7,0.636363636,1.75,2017-01-19T18:27:39Z,2017-01-30T08:16:13Z,11,7,4,0.363636364,2,3,1,6,{'LD4': 1},1,2,{'LD4': 1},Build system
9586,2,0.285714286,2,2017-01-19T18:59:32Z,2017-01-26T08:58:19Z,7,6,1,0.142857143,1,2,0,2,{},0,2,{},Tests
9600,10,1.428571429,3.333333333,2017-01-20T17:18:30Z,2017-01-27T16:09:41Z,7,4,3,0.428571429,2,3,4,6,"{'LD3': 1, 'LD1': 1, 'LD4': 1, 'LD5': 1}",2,1,"{'LD3': 1, 'LD1': 1, 'LD4': 1, 'LD5': 1}","Questions and Help,RPC/REST/ZMQ"
9601,8,0.170212766,2,2017-01-20T17:30:34Z,2017-03-07T18:31:49Z,47,43,4,0.085106383,4,5,4,4,"{'LD2': 1, 'LD3': 1, 'LD4': 1, 'LD1': 1}",3,2,"{'LD2': 1, 'LD3': 1, 'LD4': 1, 'LD1': 1}","Brainstorming,Mempool,Mining,TX fees and policy,Wallet"
9620,16,2.666666667,8,2017-01-24T00:59:04Z,2017-01-29T03:31:08Z,6,4,2,0.333333333,1,5,10,6,"{'LD4': 7, 'LD3': 1, 'LD1': 1, 'LD2': 1}",4,1,"{'LD4': 3, 'LD3': 1, 'LD1': 1, 'LD2': 1}",Wallet
9629,6,0.051724138,3,2017-01-25T14:41:35Z,2017-05-21T05:58:12Z,116,114,2,0.017241379,1,3,3,3,{'LD1': 3},2,1,{'LD1': 2},Build system
9631,1,0.5,1,2017-01-25T21:04:13Z,2017-01-27T15:18:04Z,2,1,1,0.5,1,1,0,1,{},0,1,{},"Bug,GUI"
9635,1,1,1,2017-01-26T07:18:40Z,2017-01-26T07:46:07Z,1,0,1,1,0,1,0,1,{},0,1,{},
9636,5,0.019685039,1.25,2017-01-26T11:12:55Z,2017-10-07T09:06:29Z,254,250,4,0.015748031,4,3,3,2,"{'LD3': 1, 'LD2': 1, 'LD1': 1}",3,0,"{'LD3': 1, 'LD2': 1, 'LD1': 1}",Docs
9639,13,0.058295964,2.166666667,2017-01-26T17:31:03Z,2017-09-05T18:28:06Z,223,217,6,0.02690583,4,9,4,9,"{'LD6': 1, 'LD3': 2, 'LD4': 1}",3,6,"{'LD6': 1, 'LD3': 1, 'LD4': 1}",GUI
9648,10,0.049261084,3.333333333,2017-01-28T15:00:12Z,2017-08-19T06:13:38Z,203,200,3,0.014778325,3,4,4,6,"{'LD1': 2, 'LD6': 1, 'LD3': 1}",4,0,"{'LD1': 2, 'LD6': 1, 'LD3': 1}","Build system,Windows"
9652,2,2,2,2017-01-30T09:17:33Z,2017-01-30T13:02:53Z,1,0,1,1,0,2,0,2,{},0,2,{},Questions and Help
9653,50,0.042265427,3.846153846,2017-01-30T13:17:04Z,2020-04-27T00:18:23Z,1183,1170,13,0.010989011,8,24,20,30,"{'LD1': 3, 'LD2': 1, 'LD3': 8, 'LD6': 2, 'LD4': 5, 'LD5': 1}",14,10,"{'LD1': 3, 'LD2': 1, 'LD3': 6, 'LD6': 2, 'LD4': 5, 'LD5': 1}",Brainstorming
9655,1,0.005154639,1,2017-01-31T09:58:07Z,2017-08-13T02:06:52Z,194,193,1,0.005154639,2,1,0,1,{},0,1,{},"Feature,GUI"
9661,12,0.01875,1.333333333,2017-02-01T07:15:50Z,2018-11-02T07:58:06Z,640,631,9,0.0140625,9,9,6,6,"{'LD4': 3, 'LD3': 3}",5,4,"{'LD4': 2, 'LD3': 3}","RPC/REST/ZMQ,Windows"
9664,2,2,2,2017-02-01T19:31:07Z,2017-02-01T20:02:08Z,1,0,1,1,0,2,0,2,{},0,2,{},Wallet
9666,3,3,3,2017-02-01T23:13:04Z,2017-02-02T08:38:51Z,1,0,1,1,0,3,1,2,{'LD3': 1},1,2,{'LD3': 1},P2P
9678,1,1,1,2017-02-03T13:52:10Z,2017-02-03T17:39:05Z,1,0,1,1,0,1,1,0,{'LD4': 1},1,0,{'LD4': 1},
9683,32,0.043715847,2,2017-02-04T01:22:25Z,2019-02-05T22:10:12Z,732,716,16,0.021857923,13,7,16,16,"{'LD5': 1, 'LD4': 1, 'LD1': 8, 'LD3': 5, 'LD2': 1}",6,1,"{'LD5': 1, 'LD4': 1, 'LD1': 3, 'LD3': 3, 'LD2': 1}","Bug,GUI,Wallet"
9684,5,0.004201681,2.5,2017-02-04T01:22:56Z,2020-05-08T19:21:45Z,1190,1188,2,0.001680672,2,3,3,2,"{'LD4': 2, 'LD1': 1}",3,0,"{'LD4': 2, 'LD1': 1}",UTXO Db and Indexes
9685,3,0.028846154,3,2017-02-04T03:35:27Z,2017-05-18T17:58:59Z,104,103,1,0.009615385,1,2,2,1,"{'LD1': 1, 'LD4': 1}",1,1,"{'LD1': 1, 'LD4': 1}",RPC/REST/ZMQ
9687,3,0.015789474,1,2017-02-04T10:49:58Z,2017-08-13T06:00:13Z,190,187,3,0.015789474,2,2,3,0,"{'LD2': 1, 'LD1': 1, 'LD5': 1}",2,0,"{'LD2': 1, 'LD1': 1, 'LD5': 1}",Bug
9688,3,0.6,1.5,2017-02-04T15:03:30Z,2017-02-09T09:49:59Z,5,3,2,0.4,1,3,0,3,{},0,3,{},Questions and Help
9689,2,0.001699235,1,2017-02-04T15:13:38Z,2020-04-26T00:40:04Z,1177,1175,2,0.001699235,2,2,1,1,{'LD1': 1},1,1,{'LD1': 1},Questions and Help
9694,3,0.002073255,1,2017-02-06T02:56:27Z,2021-01-22T23:18:58Z,1447,1444,3,0.002073255,2,3,1,2,{'LD5': 1},1,2,{'LD5': 1},RPC/REST/ZMQ
9702,1,0.005347594,1,2017-02-07T07:03:38Z,2017-08-13T02:12:59Z,187,186,1,0.005347594,1,1,0,1,{},0,1,{},P2P
9703,5,0.012690355,5,2017-02-07T07:55:11Z,2018-03-07T19:15:58Z,394,393,1,0.002538071,1,5,1,4,{'LD3': 1},1,4,{'LD3': 1},
9710,4,0.025,1,2017-02-07T16:10:55Z,2017-07-17T02:26:41Z,160,156,4,0.025,5,4,3,1,"{'LD4': 1, 'LD3': 1, 'LD2': 1}",3,1,"{'LD4': 1, 'LD3': 1, 'LD2': 1}","Tests,Wallet"
9723,2,0.007142857,2,2017-02-08T15:02:03Z,2017-11-14T22:09:04Z,280,279,1,0.003571429,1,2,1,1,{'LD4': 1},1,1,{'LD4': 1},RPC/REST/ZMQ
9729,3,0.006060606,1,2017-02-09T10:25:10Z,2018-06-18T15:35:09Z,495,492,3,0.006060606,2,2,1,2,{'LD4': 1},1,1,{'LD4': 1},"Resource usage,Wallet"
9741,2,2,2,2017-02-11T07:45:45Z,2017-02-11T21:06:26Z,1,0,1,1,0,2,0,2,{},0,2,{},Wallet
9742,4,1.333333333,4,2017-02-11T12:43:33Z,2017-02-14T12:29:18Z,3,2,1,0.333333333,2,2,2,2,"{'LD4': 1, 'LD3': 1}",2,0,"{'LD4': 1, 'LD3': 1}","GUI,Windows"
9746,5,0.5,1.25,2017-02-12T11:35:33Z,2017-02-21T14:13:46Z,10,6,4,0.4,1,3,1,4,{'LD4': 1},1,2,{'LD4': 1},Windows
9759,6,3,3,2017-02-14T15:29:38Z,2017-02-16T11:16:46Z,2,0,2,1,0,5,2,4,"{'LD6': 1, 'LD4': 1}",2,3,"{'LD6': 1, 'LD4': 1}",Bug
9769,6,0.014925373,1.5,2017-02-15T19:07:15Z,2018-03-23T23:27:59Z,402,398,4,0.009950249,2,4,2,4,"{'LD3': 1, 'LD5': 1}",2,2,"{'LD3': 1, 'LD5': 1}",Privacy
9772,2,0.00660066,1,2017-02-15T22:17:55Z,2017-12-14T22:26:14Z,303,301,2,0.00660066,2,2,1,1,{'LD5': 1},1,1,{'LD5': 1},Wallet
9775,2,0.5,1,2017-02-16T10:52:29Z,2017-02-19T17:08:24Z,4,2,2,0.5,1,2,1,1,{'LD4': 1},1,1,{'LD4': 1},good first issue
9776,1,1,1,2017-02-16T11:17:50Z,2017-02-16T12:55:58Z,1,0,1,1,0,1,0,1,{},0,1,{},Questions and Help
9781,1,0.5,1,2017-02-17T03:49:09Z,2017-02-19T02:34:51Z,2,1,1,0.5,1,1,0,1,{},0,1,{},
9782,1,1,1,2017-02-17T13:18:10Z,2017-02-17T16:44:08Z,1,0,1,1,0,1,1,0,{'LD1': 1},1,0,{'LD1': 1},
9797,1,1,1,2017-02-19T13:09:34Z,2017-02-19T13:22:01Z,1,0,1,1,0,1,1,0,{'LD2': 1},1,0,{'LD2': 1},
9799,2,0.00172117,1,2017-02-19T15:18:52Z,2020-04-26T00:41:04Z,1162,1160,2,0.00172117,1,2,0,2,{},0,2,{},Brainstorming
9800,4,1.333333333,4,2017-02-19T15:51:11Z,2017-02-21T17:29:13Z,3,2,1,0.333333333,1,3,0,4,{},0,3,{},Questions and Help
9810,9,9,9,2017-02-20T14:55:06Z,2017-02-21T11:35:05Z,1,0,1,1,0,2,3,6,"{'LD4': 2, 'LD1': 1}",1,1,"{'LD4': 1, 'LD1': 1}",Mempool
9811,3,0.015075377,1,2017-02-20T16:18:23Z,2017-09-06T22:40:14Z,199,196,3,0.015075377,2,3,2,1,{'LD4': 2},2,1,{'LD4': 2},TX fees and policy
9812,4,0.363636364,4,2017-02-20T16:22:10Z,2017-03-02T21:35:01Z,11,10,1,0.090909091,1,3,3,1,"{'LD4': 2, 'LD1': 1}",2,1,"{'LD4': 2, 'LD1': 1}",Resource usage
9814,4,0.04494382,1.333333333,2017-02-21T05:24:45Z,2017-05-20T11:06:32Z,89,86,3,0.033707865,2,2,3,1,"{'LD4': 1, 'LD3': 1, 'LD5': 1}",2,0,"{'LD4': 1, 'LD3': 1, 'LD5': 1}",GUI
9816,3,3,3,2017-02-21T09:30:50Z,2017-02-21T14:13:52Z,1,0,1,1,0,2,2,1,"{'LD3': 1, 'LD6': 1}",2,0,"{'LD3': 1, 'LD6': 1}",Bug
9825,1,0.166666667,1,2017-02-22T15:25:08Z,2017-02-28T15:09:31Z,6,5,1,0.166666667,1,1,1,0,{'LD2': 1},1,0,{'LD2': 1},Tests
9826,5,1,2.5,2017-02-22T15:28:58Z,2017-02-27T07:46:51Z,5,3,2,0.4,1,2,2,3,"{'LD6': 1, 'LD1': 1}",2,0,"{'LD6': 1, 'LD1': 1}",Tests
9836,8,0.173913043,2,2017-02-23T16:04:45Z,2017-04-10T08:22:20Z,46,42,4,0.086956522,2,4,2,6,"{'LD6': 1, 'LD1': 1}",2,2,"{'LD6': 1, 'LD1': 1}","Feature,P2P"
9841,1,0.090909091,1,2017-02-23T19:05:22Z,2017-03-06T17:06:34Z,11,10,1,0.090909091,1,1,0,1,{},0,1,{},
9844,6,0.005128205,1,2017-02-23T23:17:27Z,2020-05-08T19:22:51Z,1170,1164,6,0.005128205,4,4,1,5,{'LD4': 1},1,3,{'LD4': 1},Feature
9854,3,0.75,1.5,2017-02-24T22:18:54Z,2017-02-28T11:35:06Z,4,2,2,0.5,1,3,0,3,{},0,3,{},Bug
9857,16,0.071111111,2.285714286,2017-02-25T08:15:53Z,2017-10-08T03:37:16Z,225,218,7,0.031111111,6,6,9,7,"{'LD1': 4, 'LD5': 1, 'LD4': 3, 'LD3': 1}",5,1,"{'LD1': 2, 'LD5': 1, 'LD4': 3, 'LD3': 1}",Resource usage
9860,3,0.005033557,1,2017-02-26T00:02:10Z,2018-10-14T10:02:16Z,596,593,3,0.005033557,2,3,2,1,"{'LD4': 1, 'LD2': 1}",2,1,"{'LD4': 1, 'LD2': 1}","GUI,Upstream,Windows"
9862,7,7,7,2017-02-26T06:45:13Z,2017-02-26T08:56:58Z,1,0,1,1,0,2,4,3,"{'LD4': 1, 'LD3': 2, 'LD1': 1}",2,0,"{'LD4': 1, 'LD3': 2, 'LD1': 1}",
9864,1,0.000856164,1,2017-02-26T07:42:29Z,2020-05-08T19:24:03Z,1168,1167,1,0.000856164,2,1,1,0,{'LD3': 1},1,0,{'LD3': 1},"GUI,TX fees and policy"
9870,4,0.003463203,2,2017-02-27T00:36:07Z,2020-04-26T00:41:33Z,1155,1153,2,0.001731602,2,3,0,4,{},0,3,{},Feature
9877,1,1,1,2017-02-27T15:20:22Z,2017-02-28T11:34:22Z,1,0,1,1,0,1,0,1,{},0,1,{},Questions and Help
9881,1,0.005988024,1,2017-02-27T20:22:52Z,2017-08-13T02:17:04Z,167,166,1,0.005988024,1,1,0,1,{},0,1,{},Bug
9883,3,0.025,1.5,2017-02-28T00:30:02Z,2017-06-27T23:37:13Z,120,118,2,0.016666667,1,2,1,2,{'LD4': 1},1,1,{'LD4': 1},"Bug,GUI"
9885,4,4,4,2017-02-28T04:20:01Z,2017-02-28T11:20:38Z,1,0,1,1,0,3,3,1,"{'LD2': 2, 'LD1': 1}",2,1,"{'LD2': 2, 'LD1': 1}",Brainstorming
9887,2,2,2,2017-02-28T07:35:41Z,2017-02-28T11:22:34Z,1,0,1,1,0,2,0,2,{},0,2,{},Wallet
9889,28,0.173913043,1.75,2017-02-28T16:53:29Z,2017-08-08T09:54:59Z,161,145,16,0.099378882,15,7,5,23,"{'LD6': 2, 'LD4': 2, 'LD3': 1}",3,4,"{'LD6': 2, 'LD4': 2, 'LD3': 1}",Docs
9896,3,0.002601908,1.5,2017-03-01T02:41:27Z,2020-04-26T22:23:49Z,1153,1151,2,0.001734605,2,2,2,1,"{'LD4': 1, 'LD3': 1}",2,0,"{'LD4': 1, 'LD3': 1}",RPC/REST/ZMQ
9901,3,0.002604167,1.5,2017-03-02T06:26:37Z,2020-04-27T00:33:19Z,1152,1150,2,0.001736111,2,3,3,0,"{'LD4': 2, 'LD3': 1}",3,0,"{'LD4': 2, 'LD3': 1}",Docs
9914,2,0.01025641,1,2017-03-04T02:02:36Z,2017-09-14T15:41:25Z,195,193,2,0.01025641,2,2,0,2,{},0,2,{},GUI
9917,2,2,2,2017-03-04T09:02:42Z,2017-03-04T21:58:11Z,1,0,1,1,0,2,0,2,{},0,2,{},Wallet
9931,3,0.75,1.5,2017-03-06T20:13:18Z,2017-03-10T06:14:52Z,4,2,2,0.5,1,3,1,2,{'LD1': 1},1,2,{'LD1': 1},"Brainstorming,Wallet"
9934,2,0.009433962,2,2017-03-07T03:05:44Z,2017-10-04T13:01:47Z,212,211,1,0.004716981,1,1,0,2,{},0,1,{},RPC/REST/ZMQ
9944,3,0.002615519,3,2017-03-07T22:09:37Z,2020-04-27T00:31:51Z,1147,1146,1,0.00087184,1,2,0,3,{},0,2,{},Docs
9950,8,0.8,1.6,2017-03-08T14:38:51Z,2017-03-18T08:06:09Z,10,5,5,0.5,2,4,3,5,"{'LD4': 1, 'LD1': 1, 'LD3': 1}",3,1,"{'LD4': 1, 'LD1': 1, 'LD3': 1}",Bug
9954,1,1,1,2017-03-08T17:14:31Z,2017-03-08T17:19:37Z,1,0,1,1,0,1,1,0,{'LD3': 1},1,0,{'LD3': 1},
9957,2,2,2,2017-03-08T23:34:30Z,2017-03-09T15:48:49Z,1,0,1,1,0,2,1,1,{'LD2': 1},1,1,{'LD2': 1},
9961,3,0.015706806,1.5,2017-03-09T09:14:55Z,2017-09-15T23:34:17Z,191,189,2,0.010471204,2,3,2,1,"{'LD4': 1, 'LD5': 1}",2,1,"{'LD4': 1, 'LD5': 1}",good first issue
9967,1,1,1,2017-03-09T23:35:37Z,2017-03-09T23:59:12Z,1,0,1,1,0,1,0,1,{},0,1,{},
9968,7,0.4375,2.333333333,2017-03-10T01:57:49Z,2017-03-25T08:26:58Z,16,13,3,0.1875,2,4,6,1,"{'LD5': 3, 'LD3': 2, 'LD4': 1}",3,1,"{'LD5': 2, 'LD3': 1, 'LD4': 1}",
9969,12,0.067039106,2,2017-03-10T14:54:56Z,2017-09-05T13:13:53Z,179,173,6,0.033519553,5,7,3,9,"{'LD3': 2, 'LD4': 1}",3,4,"{'LD3': 2, 'LD4': 1}",Resource usage
9976,2,2,2,2017-03-11T17:18:18Z,2017-03-12T09:09:48Z,1,0,1,1,0,1,1,1,{'LD4': 1},1,0,{'LD4': 1},
9978,3,0.002606429,3,2017-03-12T01:01:18Z,2020-05-05T17:42:19Z,1151,1150,1,0.00086881,2,2,1,2,{'LD6': 1},1,1,{'LD6': 1},"Brainstorming,Feature,RPC/REST/ZMQ,Wallet"
9982,2,0.005555556,2,2017-03-13T05:32:31Z,2018-03-07T19:11:44Z,360,359,1,0.002777778,1,2,0,2,{},0,2,{},RPC/REST/ZMQ
9986,1,1,1,2017-03-13T22:02:36Z,2017-03-13T22:47:54Z,1,0,1,1,0,1,0,1,{},0,1,{},
9988,2,0.010152284,1,2017-03-14T02:48:49Z,2017-09-26T14:18:01Z,197,195,2,0.010152284,3,2,1,1,{'LD4': 1},1,1,{'LD4': 1},"Bug,RPC/REST/ZMQ"
9997,8,0.006950478,1.333333333,2017-03-15T05:45:36Z,2020-05-08T19:29:17Z,1151,1145,6,0.005212858,3,4,2,6,{'LD3': 2},1,3,{'LD3': 1},"Bug,GUI"
10001,3,0.076923077,3,2017-03-15T12:31:52Z,2017-04-23T06:47:33Z,39,38,1,0.025641026,1,2,2,1,"{'LD4': 1, 'LD1': 1}",2,0,"{'LD4': 1, 'LD1': 1}",Bug
10005,7,0.040229885,1.75,2017-03-15T22:15:57Z,2017-09-05T18:29:47Z,174,170,4,0.022988506,1,4,4,3,"{'LD4': 1, 'LD3': 2, 'LD2': 1}",2,2,"{'LD4': 1, 'LD3': 2, 'LD2': 1}",GUI
10016,3,0.008196721,1.5,2017-03-16T21:30:08Z,2018-03-17T05:44:47Z,366,364,2,0.005464481,3,3,0,3,{},0,3,{},"RPC/REST/ZMQ,Wallet"
10018,14,0.012173913,2.8,2017-03-16T22:30:46Z,2020-05-09T12:56:05Z,1150,1145,5,0.004347826,1,6,4,10,"{'LD1': 1, 'LD4': 1, 'LD6': 1, 'LD3': 1}",4,2,"{'LD1': 1, 'LD4': 1, 'LD6': 1, 'LD3': 1}","Feature,Windows"
10019,2,0.010989011,1,2017-03-17T03:20:25Z,2017-09-14T21:38:34Z,182,180,2,0.010989011,2,2,1,1,{'LD1': 1},1,1,{'LD1': 1},"RPC/REST/ZMQ,Windows"
10020,3,0.004477612,1,2017-03-17T06:59:21Z,2019-01-15T15:20:22Z,670,667,3,0.004477612,3,3,0,3,{},0,3,{},"Privacy,Wallet"
10021,3,0.002610966,3,2017-03-17T09:13:17Z,2020-05-08T19:29:50Z,1149,1148,1,0.000870322,1,2,3,0,{'LD1': 3},2,0,{'LD1': 2},"Feature,Wallet"
10025,5,0.004401408,2.5,2017-03-18T01:03:50Z,2020-04-27T00:30:57Z,1136,1134,2,0.001760563,2,2,1,4,{'LD1': 1},1,1,{'LD1': 1},P2P
10026,23,0.020246479,1.533333333,2017-03-18T08:34:02Z,2020-04-27T00:29:24Z,1136,1121,15,0.013204225,10,8,5,18,"{'LD6': 4, 'LD4': 1}",3,5,"{'LD6': 3, 'LD4': 1}",Tests
10031,1,0.5,1,2017-03-18T22:31:50Z,2017-03-20T06:50:27Z,2,1,1,0.5,1,1,1,0,{'LD2': 1},1,0,{'LD2': 1},Questions and Help
10034,4,0.028985507,2,2017-03-19T08:38:54Z,2017-08-03T11:44:34Z,138,136,2,0.014492754,2,3,0,4,{},0,3,{},"Bug,Wallet"
10041,1,0.055555556,1,2017-03-21T03:50:17Z,2017-04-07T14:12:17Z,18,17,1,0.055555556,1,1,1,0,{'LD4': 1},1,0,{'LD4': 1},Questions and Help
10042,4,4,4,2017-03-21T07:40:17Z,2017-03-21T09:58:28Z,1,0,1,1,0,1,0,4,{},0,1,{},macOS
10064,7,0.006679389,7,2017-03-23T15:31:07Z,2020-02-04T12:18:03Z,1048,1047,1,0.000954198,1,2,1,6,{'LD3': 1},1,1,{'LD3': 1},"GUI,Linux/Unix"
10065,2,0.002444988,1,2017-03-23T18:34:31Z,2019-06-19T00:20:47Z,818,816,2,0.002444988,2,2,1,1,{'LD4': 1},1,1,{'LD4': 1},"Feature,Wallet"
10066,1,1,1,2017-03-23T21:57:09Z,2017-03-24T06:48:06Z,1,0,1,1,0,1,1,0,{'LD5': 1},1,0,{'LD5': 1},
10070,1,1,1,2017-03-24T12:25:54Z,2017-03-24T12:32:30Z,1,0,1,1,0,1,1,0,{'LD4': 1},1,0,{'LD4': 1},
10071,6,0.01459854,1.2,2017-03-24T17:28:49Z,2018-05-09T04:37:14Z,411,406,5,0.01216545,4,4,3,3,"{'LD1': 1, 'LD3': 1, 'LD5': 1}",2,2,"{'LD1': 1, 'LD3': 1, 'LD5': 1}","Feature,RPC/REST/ZMQ"
10079,1,0.25,1,2017-03-25T16:25:01Z,2017-03-29T08:45:30Z,4,3,1,0.25,1,1,0,1,{},0,1,{},RPC/REST/ZMQ
10080,1,0.125,1,2017-03-26T04:22:24Z,2017-04-02T10:13:29Z,8,7,1,0.125,1,1,0,1,{},0,1,{},Refactoring
10091,2,2,2,2017-03-26T22:02:38Z,2017-03-27T12:19:38Z,1,0,1,1,0,2,2,0,"{'LD3': 1, 'LD2': 1}",2,0,"{'LD3': 1, 'LD2': 1}",Feature
10110,1,0.076923077,1,2017-03-28T19:49:45Z,2017-04-10T07:02:24Z,13,12,1,0.076923077,1,1,1,0,{'LD5': 1},1,0,{'LD5': 1},Tests
10112,8,0.007111111,2,2017-03-28T20:16:44Z,2020-04-26T00:42:02Z,1125,1121,4,0.003555556,4,8,2,6,"{'LD3': 1, 'LD1': 1}",2,6,"{'LD3': 1, 'LD1': 1}","Feature,Wallet"
10122,6,0.007211538,1.2,2017-03-30T15:06:30Z,2019-07-10T12:04:48Z,832,827,5,0.006009615,6,4,5,1,"{'LD1': 1, 'LD3': 2, 'LD4': 1, 'LD2': 1}",4,0,"{'LD1': 1, 'LD3': 1, 'LD4': 1, 'LD2': 1}","TX fees and policy,Wallet"
10131,2,0.001760563,1,2017-03-31T05:24:12Z,2020-05-09T12:54:12Z,1136,1134,2,0.001760563,2,2,0,2,{},0,2,{},"Feature,P2P"
10140,2,1,2,2017-04-02T15:56:47Z,2017-04-03T21:35:15Z,2,1,1,0.5,1,2,2,0,"{'LD2': 1, 'LD1': 1}",2,0,"{'LD2': 1, 'LD1': 1}",GUI
10163,4,0.8,1.333333333,2017-04-07T00:30:12Z,2017-04-11T07:48:43Z,5,2,3,0.6,1,3,3,1,"{'LD1': 1, 'LD4': 2}",3,0,"{'LD1': 1, 'LD4': 2}",Utils/log/libs
10170,5,0.004484305,2.5,2017-04-07T23:13:03Z,2020-04-26T09:38:31Z,1115,1113,2,0.001793722,2,3,0,5,{},0,3,{},"Build system,macOS"
10173,2,0.003610108,1,2017-04-08T21:04:18Z,2018-10-14T10:03:31Z,554,552,2,0.003610108,3,2,1,1,{'LD4': 1},1,1,{'LD4': 1},"GUI,Wallet"
10174,1,1,1,2017-04-10T06:57:54Z,2017-04-10T16:13:36Z,1,0,1,1,0,1,1,0,{'LD2': 1},1,0,{'LD2': 1},GUI
10188,9,0.008007117,4.5,2017-04-11T20:06:34Z,2020-05-08T23:25:31Z,1124,1122,2,0.001779359,2,3,1,8,{'LD5': 1},1,2,{'LD5': 1},"Brainstorming,Feature"
10203,4,1,1,2017-04-13T15:31:17Z,2017-04-17T15:10:17Z,4,0,4,1,0,3,1,3,{'LD1': 1},1,2,{'LD1': 1},"Docs,Questions and Help"
10209,4,0.016260163,1,2017-04-14T07:46:50Z,2017-12-15T21:27:26Z,246,242,4,0.016260163,2,2,4,0,"{'LD2': 1, 'LD3': 1, 'LD1': 1, 'LD4': 1}",2,0,"{'LD2': 1, 'LD3': 1, 'LD1': 1, 'LD4': 1}",P2P
10210,6,0.00446761,1.5,2017-04-14T11:51:45Z,2020-12-17T07:59:45Z,1343,1339,4,0.002978407,2,5,3,3,"{'LD2': 1, 'LD4': 1, 'LD1': 1}",2,3,"{'LD2': 1, 'LD4': 1, 'LD1': 1}",Bug
10217,1,0.000903342,1,2017-04-15T22:23:59Z,2020-04-26T00:43:00Z,1107,1106,1,0.000903342,2,1,0,1,{},0,1,{},Block storage
10218,11,11,11,2017-04-16T05:12:14Z,2017-04-16T10:22:07Z,1,0,1,1,0,2,6,5,"{'LD4': 1, 'LD1': 3, 'LD3': 2}",2,0,"{'LD4': 1, 'LD1': 1, 'LD3': 2}",
10236,8,0.007168459,2,2017-04-19T17:39:10Z,2020-05-09T12:38:28Z,1116,1112,4,0.003584229,3,4,2,6,{'LD4': 2},2,2,{'LD4': 2},Wallet
10243,2,0.333333333,1,2017-04-20T19:23:32Z,2017-04-26T08:33:11Z,6,4,2,0.333333333,2,2,1,1,{'LD4': 1},1,1,{'LD4': 1},Brainstorming
10247,37,0.151639344,2.846153846,2017-04-21T04:56:39Z,2017-12-20T19:14:36Z,244,231,13,0.053278689,7,12,15,22,"{'LD2': 1, 'LD4': 3, 'LD1': 5, 'LD5': 2, 'LD3': 4}",8,4,"{'LD2': 1, 'LD4': 3, 'LD1': 4, 'LD5': 2, 'LD3': 3}","Bug,Wallet"
10262,15,0.013489209,2.5,2017-04-23T09:20:46Z,2020-05-08T19:55:04Z,1112,1106,6,0.005395683,3,4,4,11,"{'LD3': 1, 'LD1': 2, 'LD6': 1}",2,2,"{'LD3': 1, 'LD1': 2, 'LD6': 1}",P2P
10268,1,0.111111111,1,2017-04-24T13:33:44Z,2017-05-03T06:48:09Z,9,8,1,0.111111111,2,1,1,0,{'LD3': 1},1,0,{'LD3': 1},Tests
10269,27,0.131707317,2.7,2017-04-24T14:33:27Z,2017-11-14T23:48:46Z,205,195,10,0.048780488,10,13,8,19,"{'LD4': 1, 'LD1': 4, 'LD3': 2, 'LD2': 1}",6,7,"{'LD4': 1, 'LD1': 3, 'LD3': 2, 'LD2': 1}","Windows,good first issue"
10291,1,0.007518797,1,2017-04-27T22:28:10Z,2017-09-07T19:07:08Z,133,132,1,0.007518797,1,1,0,1,{},0,1,{},GUI
10293,2,0.666666667,2,2017-04-28T19:37:12Z,2017-05-01T13:21:30Z,3,2,1,0.333333333,1,1,0,2,{},0,1,{},"Bug,Wallet"
10296,1,0.000833333,1,2017-04-28T22:38:04Z,2020-08-10T07:30:46Z,1200,1199,1,0.000833333,2,1,1,0,{'LD3': 1},1,0,{'LD3': 1},"GUI,P2P"
10300,2,0.4,1,2017-04-30T04:14:23Z,2017-05-04T09:00:13Z,5,3,2,0.4,2,2,2,0,"{'LD4': 1, 'LD5': 1}",2,0,"{'LD4': 1, 'LD5': 1}",RPC/REST/ZMQ
10306,2,0.019230769,1,2017-05-01T16:01:04Z,2017-08-13T02:30:06Z,104,102,2,0.019230769,2,2,1,1,{'LD2': 1},1,1,{'LD2': 1},"Build system,Windows"
10329,3,0.005671078,1,2017-05-03T16:20:35Z,2018-10-14T10:04:08Z,529,526,3,0.005671078,3,3,0,3,{},0,3,{},Wallet
10332,3,0.002197802,1.5,2017-05-03T19:16:49Z,2021-01-27T14:59:17Z,1365,1363,2,0.001465201,3,2,2,1,"{'LD4': 1, 'LD6': 1}",2,0,"{'LD4': 1, 'LD6': 1}",RPC/REST/ZMQ
10334,2,2,2,2017-05-03T23:11:43Z,2017-05-04T00:34:18Z,1,0,1,1,0,2,0,2,{},0,2,{},
10337,1,0.000919118,1,2017-05-04T16:50:04Z,2020-04-26T00:48:38Z,1088,1087,1,0.000919118,2,1,0,1,{},0,1,{},"GUI,Wallet"
10349,7,0.023026316,1.75,2017-05-06T19:01:35Z,2018-03-06T17:53:42Z,304,300,4,0.013157895,3,4,2,5,"{'LD3': 1, 'LD6': 1}",2,2,"{'LD3': 1, 'LD6': 1}","GUI,Wallet"
10354,1,1,1,2017-05-08T06:20:57Z,2017-05-08T13:22:55Z,1,0,1,1,0,1,0,1,{},0,1,{},
10356,5,0.015822785,1,2017-05-08T13:21:05Z,2018-03-20T13:19:36Z,316,311,5,0.015822785,4,4,3,2,"{'LD4': 1, 'LD1': 1, 'LD5': 1}",3,1,"{'LD4': 1, 'LD1': 1, 'LD5': 1}",Windows
10364,18,0.016744186,3,2017-05-08T20:53:31Z,2020-04-17T00:35:41Z,1075,1069,6,0.005581395,5,7,6,12,"{'LD3': 3, 'LD5': 2, 'LD6': 1}",4,3,"{'LD3': 2, 'LD5': 2, 'LD6': 1}","Brainstorming,Tests"
10369,2,0.001846722,1,2017-05-09T10:29:38Z,2020-04-26T00:53:50Z,1083,1081,2,0.001846722,3,2,0,2,{},0,2,{},"Feature,GUI"
10392,1,0.05,1,2017-05-12T07:44:19Z,2017-05-31T08:40:49Z,20,19,1,0.05,1,1,0,1,{},0,1,{},
10393,5,0.014925373,1.25,2017-05-12T15:38:28Z,2018-04-11T20:03:21Z,335,331,4,0.011940299,3,2,4,1,"{'LD1': 2, 'LD3': 1, 'LD5': 1}",2,0,"{'LD1': 1, 'LD3': 1, 'LD5': 1}",Tests
10394,5,0.015822785,1,2017-05-13T15:53:21Z,2018-03-25T06:31:08Z,316,311,5,0.015822785,6,4,3,2,"{'LD4': 2, 'LD1': 1}",3,1,"{'LD4': 2, 'LD1': 1}",Windows
10397,1,0.5,1,2017-05-14T03:01:36Z,2017-05-15T03:12:40Z,2,1,1,0.5,1,1,0,1,{},0,1,{},Questions and Help
10398,1,0.1,1,2017-05-14T11:11:06Z,2017-05-24T06:47:35Z,10,9,1,0.1,1,1,1,0,{'LD4': 1},1,0,{'LD4': 1},Windows
10399,4,0.333333333,2,2017-05-14T15:02:44Z,2017-05-25T18:45:41Z,12,10,2,0.166666667,1,3,3,1,"{'LD3': 1, 'LD4': 1, 'LD1': 1}",3,0,"{'LD3': 1, 'LD4': 1, 'LD1': 1}",Data corruption
10401,2,2,2,2017-05-15T04:05:50Z,2017-05-15T08:15:32Z,1,0,1,1,0,1,2,0,"{'LD2': 1, 'LD4': 1}",1,0,"{'LD2': 1, 'LD4': 1}",
10402,4,0.285714286,2,2017-05-15T07:47:53Z,2017-05-28T10:15:26Z,14,12,2,0.142857143,2,4,3,1,"{'LD4': 1, 'LD1': 1, 'LD5': 1}",3,1,"{'LD4': 1, 'LD1': 1, 'LD5': 1}",Questions and Help
10406,1,0.001004016,1,2017-05-15T16:34:08Z,2020-02-05T03:17:40Z,996,995,1,0.001004016,1,1,0,1,{},0,1,{},GUI
10411,1,0.000929368,1,2017-05-16T19:34:34Z,2020-04-26T00:55:50Z,1076,1075,1,0.000929368,1,1,0,1,{},0,1,{},"RPC/REST/ZMQ,Wallet"
10416,1,1,1,2017-05-17T14:00:29Z,2017-05-17T23:58:35Z,1,0,1,1,0,1,1,0,{'LD2': 1},1,0,{'LD2': 1},
10418,1,0.01754386,1,2017-05-17T20:23:54Z,2017-07-13T18:02:41Z,57,56,1,0.01754386,2,1,0,1,{},0,1,{},TX fees and policy
10430,3,0.5,1.5,2017-05-19T05:34:34Z,2017-05-25T04:58:33Z,6,4,2,0.333333333,2,2,1,2,{'LD4': 1},1,1,{'LD4': 1},Windows
10435,2,0.666666667,1,2017-05-20T06:39:49Z,2017-05-23T05:04:23Z,3,1,2,0.666666667,1,2,1,1,{'LD1': 1},1,1,{'LD1': 1},Mempool
10436,2,0.001865672,1,2017-05-20T16:03:08Z,2020-04-26T01:11:11Z,1072,1070,2,0.001865672,2,2,2,0,"{'LD4': 1, 'LD3': 1}",2,0,"{'LD4': 1, 'LD3': 1}",RPC/REST/ZMQ
10438,1,1,1,2017-05-22T06:45:51Z,2017-05-22T07:00:17Z,1,0,1,1,0,1,1,0,{'LD2': 1},1,0,{'LD2': 1},
10452,2,0.285714286,2,2017-05-25T09:58:48Z,2017-05-31T13:11:24Z,7,6,1,0.142857143,1,1,0,2,{},0,1,{},GUI
10453,1,1,1,2017-05-25T10:52:35Z,2017-05-25T12:33:13Z,1,0,1,1,0,1,1,0,{'LD5': 1},1,0,{'LD5': 1},
10465,2,0.5,2,2017-05-27T05:51:27Z,2017-05-30T18:49:05Z,4,3,1,0.25,1,1,2,0,"{'LD2': 1, 'LD1': 1}",1,0,"{'LD2': 1, 'LD1': 1}",TX fees and policy
10466,1,1,1,2017-05-27T09:19:20Z,2017-05-27T17:29:58Z,1,0,1,1,0,1,0,1,{},0,1,{},
10472,3,3,3,2017-05-29T04:32:50Z,2017-05-29T19:02:54Z,1,0,1,1,0,1,0,3,{},0,1,{},Questions and Help
10474,5,0.040322581,1.25,2017-05-29T17:25:36Z,2017-09-30T08:37:14Z,124,120,4,0.032258065,2,4,3,2,"{'LD4': 2, 'LD2': 1}",2,2,"{'LD4': 2, 'LD2': 1}",Questions and Help
10482,2,2,2,2017-05-31T03:14:37Z,2017-05-31T03:33:47Z,1,0,1,1,0,2,0,2,{},0,2,{},Questions and Help
10485,1,1,1,2017-05-31T13:05:29Z,2017-05-31T14:29:12Z,1,0,1,1,0,1,1,0,{'LD1': 1},1,0,{'LD1': 1},Wallet
10487,1,1,1,2017-05-31T15:47:17Z,2017-06-01T05:53:52Z,1,0,1,1,0,1,0,1,{},0,1,{},
10490,2,0.25,2,2017-05-31T18:59:37Z,2017-06-08T18:31:13Z,8,7,1,0.125,2,1,0,2,{},0,1,{},TX fees and policy
10491,1,1,1,2017-05-31T22:14:01Z,2017-06-01T11:10:30Z,1,0,1,1,0,1,0,1,{},0,1,{},Wallet
10492,5,0.004655493,1.666666667,2017-05-31T22:32:40Z,2020-05-09T12:32:43Z,1074,1071,3,0.002793296,3,5,2,3,"{'LD4': 1, 'LD3': 1}",2,3,"{'LD4': 1, 'LD3': 1}","Resource usage,Wallet"
10494,3,0.030927835,1.5,2017-06-01T06:53:57Z,2017-09-06T00:15:39Z,97,95,2,0.020618557,2,3,2,1,{'LD2': 2},2,1,{'LD2': 2},Brainstorming
10499,2,2,2,2017-06-01T15:25:36Z,2017-06-01T15:46:39Z,1,0,1,1,0,2,1,1,{'LD4': 1},1,1,{'LD4': 1},
10505,3,0.006289308,1,2017-06-01T18:52:57Z,2018-09-21T00:38:55Z,477,474,3,0.006289308,4,3,0,3,{},0,3,{},"Build system,GUI"
10507,2,0.015748031,1,2017-06-02T10:43:56Z,2017-10-07T02:49:56Z,127,125,2,0.015748031,2,2,2,0,"{'LD4': 1, 'LD5': 1}",2,0,"{'LD4': 1, 'LD5': 1}","Build system,macOS"
10510,2,0.4,1,2017-06-02T20:16:09Z,2017-06-07T14:37:38Z,5,3,2,0.4,1,2,1,1,{'LD4': 1},1,1,{'LD4': 1},Wallet
10525,1,0.333333333,1,2017-06-04T15:03:54Z,2017-06-06T16:23:42Z,3,2,1,0.333333333,1,1,1,0,{'LD1': 1},1,0,{'LD1': 1},RPC/REST/ZMQ
10528,1,1,1,2017-06-04T20:51:45Z,2017-06-05T13:40:50Z,1,0,1,1,0,1,1,0,{'LD1': 1},1,0,{'LD1': 1},Questions and Help
10562,2,0.001897533,1,2017-06-09T00:07:46Z,2020-04-27T00:37:12Z,1054,1052,2,0.001897533,3,2,2,0,{'LD1': 2},2,0,{'LD1': 2},"Mempool,RPC/REST/ZMQ"
10570,1,0.002197802,1,2017-06-10T04:10:56Z,2018-09-07T04:30:00Z,455,454,1,0.002197802,1,1,0,1,{},0,1,{},RPC/REST/ZMQ
10572,2,0.016949153,1,2017-06-11T19:54:30Z,2017-10-07T14:52:48Z,118,116,2,0.016949153,3,2,1,1,{'LD2': 1},1,1,{'LD2': 1},Windows
10576,3,0.428571429,1.5,2017-06-11T23:29:34Z,2017-06-18T20:27:48Z,7,5,2,0.285714286,2,2,3,0,"{'LD1': 1, 'LD2': 1, 'LD5': 1}",2,0,"{'LD1': 1, 'LD2': 1, 'LD5': 1}",Windows
10590,4,0.105263158,2,2017-06-14T20:11:01Z,2017-07-21T20:16:17Z,38,36,2,0.052631579,3,3,1,3,{'LD5': 1},1,2,{'LD5': 1},GUI
10599,1,0.001140251,1,2017-06-15T14:20:47Z,2019-11-09T07:55:14Z,877,876,1,0.001140251,1,1,1,0,{'LD4': 1},1,0,{'LD4': 1},RPC/REST/ZMQ
10601,1,0.071428571,1,2017-06-15T15:06:26Z,2017-06-28T17:13:52Z,14,13,1,0.071428571,2,1,1,0,{'LD2': 1},1,0,{'LD2': 1},"Docs,Tests"
10603,3,0.010204082,1,2017-06-15T17:35:02Z,2018-04-05T14:26:37Z,294,291,3,0.010204082,2,3,1,2,{'LD5': 1},1,2,{'LD5': 1},Tests
10606,1,1,1,2017-06-15T19:48:53Z,2017-06-15T19:51:00Z,1,0,1,1,0,1,1,0,{'LD2': 1},1,0,{'LD2': 1},
10609,4,0.003816794,1,2017-06-16T05:04:53Z,2020-04-28T12:40:59Z,1048,1044,4,0.003816794,4,4,1,3,{'LD1': 1},1,3,{'LD1': 1},Feature
10610,2,0.034482759,2,2017-06-16T07:14:59Z,2017-08-13T02:28:36Z,58,57,1,0.017241379,1,2,0,2,{},0,2,{},Windows
10616,14,0.037533512,2.333333333,2017-06-16T22:16:00Z,2018-06-24T19:05:00Z,373,367,6,0.016085791,5,7,4,10,"{'LD4': 2, 'LD3': 2}",4,3,"{'LD4': 2, 'LD3': 2}","Brainstorming,Build system"
10617,3,3,3,2017-06-16T23:06:24Z,2017-06-17T18:48:54Z,1,0,1,1,0,2,3,0,"{'LD5': 1, 'LD2': 2}",2,0,"{'LD5': 1, 'LD2': 1}",
10620,5,0.020661157,1.25,2017-06-17T18:16:27Z,2018-02-14T11:16:02Z,242,238,4,0.016528926,3,3,2,3,{'LD4': 2},1,2,{'LD4': 1},macOS
10622,2,0.25,1,2017-06-18T04:57:28Z,2017-06-25T12:08:52Z,8,6,2,0.25,1,1,0,2,{},0,1,{},Build system
10624,1,0.125,1,2017-06-18T09:10:45Z,2017-06-26T07:12:38Z,8,7,1,0.125,2,1,1,0,{'LD4': 1},1,0,{'LD4': 1},Windows
10630,1,0.018181818,1,2017-06-19T12:03:26Z,2017-08-13T02:10:08Z,55,54,1,0.018181818,1,1,1,0,{'LD3': 1},1,0,{'LD3': 1},Linux/Unix
10641,2,2,2,2017-06-21T07:45:41Z,2017-06-21T07:47:12Z,1,0,1,1,0,2,0,2,{},0,2,{},
10647,9,0.75,2.25,2017-06-21T20:09:43Z,2017-07-03T18:36:31Z,12,8,4,0.333333333,2,2,5,4,"{'LD1': 3, 'LD4': 1, 'LD5': 1}",2,0,"{'LD1': 2, 'LD4': 1, 'LD5': 1}","Resource usage,Windows"
10664,2,2,2,2017-06-24T02:49:08Z,2017-06-24T09:50:42Z,1,0,1,1,0,2,1,1,{'LD1': 1},1,1,{'LD1': 1},"Questions and Help,Resource usage"
10666,5,0.04587156,1,2017-06-24T05:30:18Z,2017-10-10T07:14:19Z,109,104,5,0.04587156,3,5,3,2,"{'LD4': 1, 'LD3': 1, 'LD5': 1}",3,2,"{'LD4': 1, 'LD3': 1, 'LD5': 1}","RPC/REST/ZMQ,Wallet"
10670,4,0.181818182,1.333333333,2017-06-26T09:08:33Z,2017-07-17T12:50:11Z,22,19,3,0.136363636,3,2,3,1,{'LD3': 3},1,1,{'LD3': 1},Build system
10671,2,2,2,2017-06-26T10:00:48Z,2017-06-27T09:34:37Z,1,0,1,1,0,1,2,0,"{'LD4': 1, 'LD2': 1}",1,0,"{'LD4': 1, 'LD2': 1}","Questions and Help,Wallet"
10674,3,0.004754358,1.5,2017-06-27T01:26:21Z,2019-03-19T13:44:41Z,631,629,2,0.003169572,2,2,1,2,{'LD5': 1},1,1,{'LD5': 1},"Brainstorming,RPC/REST/ZMQ"
10678,3,0.01734104,1,2017-06-27T06:35:10Z,2017-12-17T02:36:46Z,173,170,3,0.01734104,3,2,2,1,{'LD2': 2},2,0,{'LD2': 2},Tests
10687,3,3,3,2017-06-28T04:11:34Z,2017-06-29T02:18:53Z,1,0,1,1,0,3,2,1,"{'LD1': 1, 'LD4': 1}",2,1,"{'LD1': 1, 'LD4': 1}","Build system,macOS"
10700,1,1,1,2017-06-29T04:26:19Z,2017-06-29T13:00:21Z,1,0,1,1,0,1,0,1,{},0,1,{},Windows
10709,5,0.020491803,1.666666667,2017-06-30T08:12:53Z,2018-02-28T18:15:59Z,244,241,3,0.012295082,3,5,3,2,"{'LD4': 1, 'LD1': 2}",3,2,"{'LD4': 1, 'LD1': 2}","GUI,Windows"
10716,1,1,1,2017-07-02T21:53:37Z,2017-07-02T22:06:15Z,1,0,1,1,0,1,0,1,{},0,1,{},
10725,1,1,1,2017-07-03T02:20:32Z,2017-07-03T02:43:16Z,1,0,1,1,0,1,0,1,{},0,1,{},
10726,1,1,1,2017-07-03T03:06:41Z,2017-07-03T03:21:19Z,1,0,1,1,0,1,0,1,{},0,1,{},
10734,1,0.010416667,1,2017-07-03T14:43:06Z,2017-10-07T14:36:29Z,96,95,1,0.010416667,1,1,1,0,{'LD1': 1},1,0,{'LD1': 1},
10736,9,0.033457249,1.285714286,2017-07-03T18:44:33Z,2018-03-29T11:56:39Z,269,262,7,0.026022305,7,5,3,6,"{'LD6': 1, 'LD3': 1, 'LD2': 1}",3,2,"{'LD6': 1, 'LD3': 1, 'LD2': 1}",
10741,2,0.007782101,1,2017-07-04T15:46:04Z,2018-03-17T20:23:18Z,257,255,2,0.007782101,2,2,1,1,{'LD4': 1},1,1,{'LD4': 1},"GUI,Questions and Help"
10751,2,0.015503876,2,2017-07-05T18:54:41Z,2017-11-11T16:48:38Z,129,128,1,0.007751938,1,2,1,1,{'LD3': 1},1,1,{'LD3': 1},"RPC/REST/ZMQ,Tests"
10778,2,0.083333333,1,2017-07-09T04:38:37Z,2017-08-01T10:11:10Z,24,22,2,0.083333333,2,2,1,1,{'LD5': 1},1,1,{'LD5': 1},Validation
10787,6,0.005808325,1.5,2017-07-10T21:19:07Z,2020-05-08T19:57:35Z,1033,1029,4,0.003872217,3,5,4,2,"{'LD4': 2, 'LD3': 2}",4,1,"{'LD4': 2, 'LD3': 2}","Upstream,macOS"
10791,2,0.034482759,1,2017-07-11T07:16:16Z,2017-09-06T17:30:38Z,58,56,2,0.034482759,2,2,1,1,{'LD3': 1},1,1,{'LD3': 1},"Tests,Utils/log/libs"
10796,1,0.026315789,1,2017-07-11T20:54:31Z,2017-08-18T13:22:24Z,38,37,1,0.026315789,2,1,0,1,{},0,1,{},"Docs,Linux/Unix"
10797,3,1.5,1.5,2017-07-11T21:55:03Z,2017-07-13T19:26:15Z,2,0,2,1,0,3,1,2,{'LD1': 1},1,2,{'LD1': 1},Build system
10801,6,0.031746032,1,2017-07-12T10:00:50Z,2018-01-16T19:39:25Z,189,183,6,0.031746032,5,4,3,3,"{'LD4': 1, 'LD3': 1, 'LD1': 1}",2,2,"{'LD4': 1, 'LD3': 1, 'LD1': 1}","Linux/Unix,Tests"
10811,1,1,1,2017-07-12T22:07:42Z,2017-07-12T23:49:51Z,1,0,1,1,0,1,1,0,{'LD1': 1},1,0,{'LD1': 1},
10813,1,1,1,2017-07-13T07:51:11Z,2017-07-13T12:11:56Z,1,0,1,1,0,1,1,0,{'LD4': 1},1,0,{'LD4': 1},
10815,1,0.2,1,2017-07-13T14:52:03Z,2017-07-17T15:20:22Z,5,4,1,0.2,1,1,0,1,{},0,1,{},GUI
10826,4,0.025316456,2,2017-07-14T16:03:47Z,2017-12-19T08:19:38Z,158,156,2,0.012658228,2,3,2,2,"{'LD1': 1, 'LD3': 1}",2,1,"{'LD1': 1, 'LD3': 1}",Build system
10828,1,0.008695652,1,2017-07-14T17:49:04Z,2017-11-06T10:30:43Z,115,114,1,0.008695652,1,1,0,1,{},0,1,{},Build system
10836,2,0.181818182,1,2017-07-15T19:19:22Z,2017-07-26T06:12:47Z,11,9,2,0.181818182,2,2,0,2,{},0,2,{},Windows
10848,3,3,3,2017-07-17T07:59:39Z,2017-07-17T08:09:57Z,1,0,1,1,0,3,1,2,{'LD2': 1},1,2,{'LD2': 1},
10850,2,0.008196721,1,2017-07-17T12:33:01Z,2018-03-17T20:25:28Z,244,242,2,0.008196721,2,2,1,1,{'LD4': 1},1,1,{'LD4': 1},Linux/Unix
10856,7,0.212121212,1.166666667,2017-07-17T20:51:50Z,2017-08-19T06:10:42Z,33,27,6,0.181818182,5,5,3,4,"{'LD2': 2, 'LD1': 1}",2,3,"{'LD2': 2, 'LD1': 1}",Windows
10860,4,0.011363636,1.333333333,2017-07-18T03:26:59Z,2018-07-04T04:10:21Z,352,349,3,0.008522727,2,4,2,2,"{'LD3': 1, 'LD4': 1}",2,2,"{'LD3': 1, 'LD4': 1}",
10861,2,0.090909091,2,2017-07-18T12:01:56Z,2017-08-09T08:23:33Z,22,21,1,0.045454545,1,2,1,1,{'LD4': 1},1,1,{'LD4': 1},GUI
10869,3,0.01119403,1,2017-07-18T17:16:56Z,2018-04-11T20:14:38Z,268,265,3,0.01119403,3,2,0,3,{},0,2,{},Tests
10897,7,0.08974359,1.4,2017-07-21T17:57:27Z,2017-10-07T11:36:23Z,78,73,5,0.064102564,5,4,1,6,{'LD1': 1},1,3,{'LD1': 1},Data corruption
10902,2,0.105263158,1,2017-07-21T23:51:03Z,2017-08-09T08:22:30Z,19,17,2,0.105263158,2,2,1,1,{'LD4': 1},1,1,{'LD4': 1},macOS
10904,2,1,1,2017-07-22T09:52:30Z,2017-07-24T08:26:18Z,2,0,2,1,0,2,0,2,{},0,2,{},
10905,1,0.5,1,2017-07-22T09:59:43Z,2017-07-24T08:28:10Z,2,1,1,0.5,1,1,0,1,{},0,1,{},
10906,1,1,1,2017-07-22T10:15:06Z,2017-07-22T20:34:04Z,1,0,1,1,0,1,0,1,{},0,1,{},
10909,3,1,1.5,2017-07-22T12:17:58Z,2017-07-25T11:51:10Z,3,1,2,0.666666667,1,1,2,1,{'LD4': 2},1,0,{'LD4': 1},"Build system,Windows"
10910,1,0.333333333,1,2017-07-22T16:45:00Z,2017-07-25T08:55:27Z,3,2,1,0.333333333,1,1,1,0,{'LD1': 1},1,0,{'LD1': 1},Build system
10918,1,0.002898551,1,2017-07-24T16:49:37Z,2018-07-04T04:12:04Z,345,344,1,0.002898551,2,1,0,1,{},0,1,{},GUI
10921,1,0.007352941,1,2017-07-24T22:11:35Z,2017-12-07T00:11:32Z,136,135,1,0.007352941,1,1,0,1,{},0,1,{},Wallet
10924,4,0.055555556,2,2017-07-25T09:12:42Z,2017-10-05T06:52:32Z,72,70,2,0.027777778,3,3,0,4,{},0,3,{},"Bug,RPC/REST/ZMQ"
10926,6,0.4,6,2017-07-25T12:02:38Z,2017-08-09T08:23:02Z,15,14,1,0.066666667,1,3,3,3,{'LD1': 3},1,2,{'LD1': 1},"Build system,macOS"
10930,3,0.166666667,1,2017-07-26T07:28:23Z,2017-08-13T04:15:53Z,18,15,3,0.166666667,3,1,0,3,{},0,1,{},Build system
10938,1,1,1,2017-07-26T10:26:23Z,2017-07-27T04:48:28Z,1,0,1,1,0,1,0,1,{},0,1,{},Linux/Unix
10951,4,0.333333333,2,2017-07-28T15:14:28Z,2017-08-09T09:30:35Z,12,10,2,0.166666667,2,4,3,1,{'LD1': 3},3,1,{'LD1': 3},Build system
10959,2,2,2,2017-07-31T08:42:53Z,2017-07-31T14:41:50Z,1,0,1,1,0,1,1,1,{'LD1': 1},1,0,{'LD1': 1},
10960,1,0.1,1,2017-07-31T09:08:41Z,2017-08-09T09:31:51Z,10,9,1,0.1,1,1,1,0,{'LD4': 1},1,0,{'LD4': 1},Build system
10962,2,0.006289308,1,2017-07-31T14:51:58Z,2018-06-13T21:05:07Z,318,316,2,0.006289308,2,2,1,1,{'LD3': 1},1,1,{'LD3': 1},"Docs,GUI"
10978,7,1,3.5,2017-08-02T14:52:56Z,2017-08-09T08:25:29Z,7,5,2,0.285714286,3,5,2,5,"{'LD3': 1, 'LD1': 1}",2,3,"{'LD3': 1, 'LD1': 1}",
10979,1,1,1,2017-08-03T08:16:08Z,2017-08-03T08:30:42Z,1,0,1,1,0,1,0,1,{},0,1,{},
10987,3,0.010989011,1,2017-08-04T01:27:33Z,2018-05-03T09:28:42Z,273,270,3,0.010989011,4,3,1,2,{'LD2': 1},1,2,{'LD2': 1},Wallet
10992,2,0.006079027,1,2017-08-05T08:45:54Z,2018-06-29T19:02:33Z,329,327,2,0.006079027,3,2,1,1,{'LD3': 1},1,1,{'LD3': 1},GUI
10993,3,0.008595989,1,2017-08-05T14:36:03Z,2018-07-20T13:14:24Z,349,346,3,0.008595989,3,3,0,3,{},0,3,{},P2P
11004,6,0.021818182,1.2,2017-08-07T23:23:14Z,2018-05-09T07:51:47Z,275,270,5,0.018181818,3,5,3,3,"{'LD3': 2, 'LD6': 1}",3,2,"{'LD3': 2, 'LD6': 1}",Tests
11014,1,1,1,2017-08-09T02:41:55Z,2017-08-09T04:51:20Z,1,0,1,1,0,1,0,1,{},0,1,{},
11016,2,0.002666667,1,2017-08-09T07:39:54Z,2019-08-28T20:03:58Z,750,748,2,0.002666667,2,2,2,0,{'LD3': 2},2,0,{'LD3': 2},GUI
11030,1,0.004784689,1,2017-08-11T08:48:51Z,2018-03-07T19:03:56Z,209,208,1,0.004784689,2,1,1,0,{'LD1': 1},1,0,{'LD1': 1},Windows
11033,18,0.195652174,2.571428571,2017-08-11T20:14:46Z,2017-11-11T07:27:01Z,92,85,7,0.076086957,4,7,9,9,"{'LD3': 1, 'LD4': 5, 'LD6': 2, 'LD5': 1}",5,2,"{'LD3': 1, 'LD4': 4, 'LD6': 2, 'LD5': 1}","GUI,good first issue"
11036,3,0.034482759,3,2017-08-12T15:21:03Z,2017-11-07T05:11:38Z,87,86,1,0.011494253,1,2,3,0,"{'LD4': 2, 'LD1': 1}",2,0,"{'LD4': 2, 'LD1': 1}",macOS
11037,5,0.024271845,5,2017-08-12T22:04:35Z,2018-03-06T21:56:28Z,206,205,1,0.004854369,1,2,2,3,"{'LD3': 1, 'LD4': 1}",1,1,"{'LD3': 1, 'LD4': 1}",P2P
11038,2,0.035714286,1,2017-08-13T04:38:48Z,2017-10-07T08:56:06Z,56,54,2,0.035714286,2,2,1,1,{'LD1': 1},1,1,{'LD1': 1},Windows
11040,2,0.023255814,1,2017-08-13T16:03:07Z,2017-11-07T05:13:15Z,86,84,2,0.023255814,3,2,1,1,{'LD3': 1},1,1,{'LD3': 1},macOS
11045,29,0.029682702,1.933333333,2017-08-14T18:13:52Z,2020-04-16T20:20:35Z,977,962,15,0.015353122,11,9,12,17,"{'LD6': 1, 'LD4': 6, 'LD3': 4, 'LD2': 1}",5,4,"{'LD6': 1, 'LD4': 3, 'LD3': 3, 'LD2': 1}",Tests
11048,6,0.038461538,1.5,2017-08-14T20:55:40Z,2018-01-17T13:27:24Z,156,152,4,0.025641026,3,6,2,4,"{'LD4': 1, 'LD1': 1}",2,4,"{'LD4': 1, 'LD1': 1}","RPC/REST/ZMQ,Wallet"
11054,10,0.056497175,1.111111111,2017-08-15T15:49:35Z,2018-02-08T15:39:23Z,177,168,9,0.050847458,8,4,2,8,"{'LD2': 1, 'LD5': 1}",2,2,"{'LD2': 1, 'LD5': 1}",Docs
11057,2,0.002030457,1,2017-08-15T23:03:33Z,2020-04-26T01:12:29Z,985,983,2,0.002030457,3,2,1,1,{'LD3': 1},1,1,{'LD3': 1},"Linux/Unix,Upstream"
11060,2,0.002,1,2017-08-16T02:26:20Z,2020-05-11T23:00:27Z,1000,998,2,0.002,3,2,0,2,{},0,2,{},"RPC/REST/ZMQ,TX fees and policy"
11061,3,0.004160888,1.5,2017-08-16T04:11:35Z,2019-08-06T14:35:27Z,721,719,2,0.002773925,2,2,2,1,{'LD1': 2},2,0,{'LD1': 2},Mining
11063,2,0.009803922,1,2017-08-16T08:46:54Z,2018-03-07T19:01:34Z,204,202,2,0.009803922,3,1,2,0,"{'LD4': 1, 'LD3': 1}",1,0,"{'LD4': 1, 'LD3': 1}",Linux/Unix
11064,1,1,1,2017-08-16T09:08:59Z,2017-08-16T10:07:14Z,1,0,1,1,0,1,0,1,{},0,1,{},Brainstorming
11070,5,0.007518797,1,2017-08-16T18:30:04Z,2019-06-12T14:42:06Z,665,660,5,0.007518797,3,5,2,3,"{'LD3': 1, 'LD6': 1}",2,3,"{'LD3': 1, 'LD6': 1}",Wallet
11072,1,1,1,2017-08-17T04:02:33Z,2017-08-17T05:43:42Z,1,0,1,1,0,1,1,0,{'LD1': 1},1,0,{'LD1': 1},
11079,1,0.018181818,1,2017-08-17T15:49:31Z,2017-10-10T18:14:08Z,55,54,1,0.018181818,2,1,1,0,{'LD3': 1},1,0,{'LD3': 1},"Data corruption,P2P"
11086,2,0.1,1,2017-08-18T09:53:32Z,2017-09-06T20:50:56Z,20,18,2,0.1,1,2,0,2,{},0,2,{},"Feature,Mempool"
11088,1,0.5,1,2017-08-18T14:00:22Z,2017-08-20T09:11:11Z,2,1,1,0.5,1,1,0,1,{},0,1,{},
11096,1,1,1,2017-08-19T11:31:49Z,2017-08-19T20:35:28Z,1,0,1,1,0,1,1,0,{'LD1': 1},1,0,{'LD1': 1},
11105,2,2,2,2017-08-21T12:20:40Z,2017-08-21T15:27:25Z,1,0,1,1,0,2,1,1,{'LD2': 1},1,1,{'LD2': 1},
11114,4,0.086956522,1.333333333,2017-08-22T23:55:49Z,2017-10-07T08:53:10Z,46,43,3,0.065217391,3,3,1,3,{'LD4': 1},1,2,{'LD4': 1},Bug
11115,1,0.001022495,1,2017-08-23T00:00:56Z,2020-04-26T01:14:00Z,978,977,1,0.001022495,1,1,0,1,{},0,1,{},
11123,2,0.4,1,2017-08-24T05:34:43Z,2017-08-29T00:37:11Z,5,3,2,0.4,1,2,1,1,{'LD1': 1},1,1,{'LD1': 1},"Build system,Windows"
11124,21,0.141891892,2.625,2017-08-24T05:36:15Z,2018-01-18T19:03:38Z,148,140,8,0.054054054,7,13,9,12,"{'LD3': 3, 'LD4': 4, 'LD6': 1, 'LD2': 1}",6,7,"{'LD3': 3, 'LD4': 2, 'LD6': 1, 'LD2': 1}",GUI
11134,13,0.058823529,2.166666667,2017-08-25T14:21:28Z,2018-04-02T18:56:38Z,221,215,6,0.027149321,6,8,2,11,"{'LD3': 1, 'LD4': 1}",2,6,"{'LD3': 1, 'LD4': 1}",RPC/REST/ZMQ
11137,2,0.166666667,2,2017-08-25T16:16:23Z,2017-09-05T23:04:24Z,12,11,1,0.083333333,2,1,0,2,{},0,1,{},
11141,2,0.666666667,2,2017-08-25T16:57:59Z,2017-08-27T22:33:40Z,3,2,1,0.333333333,1,2,0,2,{},0,2,{},
11146,2,0.5,2,2017-08-25T21:09:18Z,2017-08-29T04:42:30Z,4,3,1,0.25,1,2,1,1,{'LD1': 1},1,1,{'LD1': 1},RPC/REST/ZMQ
11157,2,2,2,2017-08-26T10:36:07Z,2017-08-27T03:38:22Z,1,0,1,1,0,2,1,1,{'LD2': 1},1,1,{'LD2': 1},
11158,3,3,3,2017-08-26T10:46:23Z,2017-08-26T13:02:23Z,1,0,1,1,0,2,1,2,{'LD4': 1},1,1,{'LD4': 1},
11162,1,1,1,2017-08-26T14:42:33Z,2017-08-26T20:25:20Z,1,0,1,1,0,1,1,0,{'LD3': 1},1,0,{'LD3': 1},
11166,1,0.013513514,1,2017-08-26T20:49:41Z,2017-11-08T01:01:49Z,74,73,1,0.013513514,2,1,0,1,{},0,1,{},Refactoring
11171,19,0.463414634,3.8,2017-08-27T14:55:23Z,2017-10-07T02:55:52Z,41,36,5,0.12195122,4,6,6,13,"{'LD4': 1, 'LD1': 1, 'LD2': 1, 'LD5': 1, 'LD3': 2}",3,3,"{'LD4': 1, 'LD1': 1, 'LD2': 1, 'LD5': 1, 'LD3': 2}",Windows
11174,2,0.048780488,1,2017-08-28T07:17:04Z,2017-10-07T13:08:40Z,41,39,2,0.048780488,3,2,1,1,{'LD5': 1},1,1,{'LD5': 1},"Docs,good first issue"
11175,1,1,1,2017-08-28T07:19:35Z,2017-08-28T10:19:43Z,1,0,1,1,0,1,1,0,{'LD5': 1},1,0,{'LD5': 1},
11189,2,0.25,1,2017-08-29T10:30:42Z,2017-09-05T23:15:19Z,8,6,2,0.25,2,2,0,2,{},0,2,{},Questions and Help
11197,1,1,1,2017-08-30T17:34:34Z,2017-08-30T18:35:31Z,1,0,1,1,0,1,0,1,{},0,1,{},GUI
11202,1,0.333333333,1,2017-08-31T05:29:56Z,2017-09-02T05:51:22Z,3,2,1,0.333333333,2,1,0,1,{},0,1,{},
11207,6,0.24,1.5,2017-08-31T19:35:11Z,2017-09-25T11:17:47Z,25,21,4,0.16,3,4,4,2,"{'LD2': 2, 'LD3': 2}",2,2,"{'LD2': 2, 'LD3': 1}",Windows
11209,1,0.025641026,1,2017-09-01T02:24:55Z,2017-10-09T14:11:34Z,39,38,1,0.025641026,1,1,1,0,{'LD6': 1},1,0,{'LD6': 1},GUI
11211,1,0.125,1,2017-09-01T13:37:15Z,2017-09-09T00:12:39Z,8,7,1,0.125,2,1,0,1,{},0,1,{},"Build system,Windows"
11217,5,1.25,1.25,2017-09-02T09:26:29Z,2017-09-05T14:54:27Z,4,0,4,1,0,3,3,2,"{'LD3': 1, 'LD1': 1, 'LD5': 1}",2,1,"{'LD3': 1, 'LD1': 1, 'LD5': 1}","Questions and Help,Windows"
11218,6,0.01,1.2,2017-09-02T10:27:55Z,2019-04-25T09:43:56Z,600,595,5,0.008333333,4,5,2,4,"{'LD3': 1, 'LD4': 1}",2,3,"{'LD3': 1, 'LD4': 1}","RPC/REST/ZMQ,good first issue"
11223,2,0.00990099,2,2017-09-03T10:26:34Z,2018-03-23T20:18:39Z,202,201,1,0.004950495,1,1,0,2,{},0,1,{},TX fees and policy
11243,11,0.171875,2.75,2017-09-05T18:48:06Z,2017-11-08T09:29:53Z,64,60,4,0.0625,3,5,4,7,"{'LD3': 3, 'LD2': 1}",3,2,"{'LD3': 2, 'LD2': 1}","Docs,RPC/REST/ZMQ,good first issue"
11251,1,0.5,1,2017-09-06T00:27:44Z,2017-09-07T00:55:40Z,2,1,1,0.5,1,1,0,1,{},0,1,{},"Build system,Docs"
11254,1,1,1,2017-09-06T08:14:04Z,2017-09-07T00:59:28Z,1,0,1,1,0,1,1,0,{'LD1': 1},1,0,{'LD1': 1},"GUI,RPC/REST/ZMQ"
11257,5,0.138888889,2.5,2017-09-06T14:08:16Z,2017-10-12T12:55:29Z,36,34,2,0.055555556,2,2,3,2,"{'LD4': 1, 'LD3': 1, 'LD5': 1}",2,0,"{'LD4': 1, 'LD3': 1, 'LD5': 1}",RPC/REST/ZMQ
11262,5,0.357142857,1.666666667,2017-09-07T10:17:11Z,2017-09-20T10:42:59Z,14,11,3,0.214285714,3,3,2,3,"{'LD5': 1, 'LD2': 1}",2,1,"{'LD5': 1, 'LD2': 1}","Bug,GUI"
11263,1,1,1,2017-09-07T11:55:35Z,2017-09-07T21:48:29Z,1,0,1,1,0,1,0,1,{},0,1,{},Consensus
11265,1,1,1,2017-09-07T13:13:31Z,2017-09-07T19:12:09Z,1,0,1,1,0,1,0,1,{},0,1,{},
11266,1,1,1,2017-09-07T14:44:08Z,2017-09-07T22:03:32Z,1,0,1,1,0,1,1,0,{'LD2': 1},1,0,{'LD2': 1},
11275,3,0.1,1.5,2017-09-07T21:16:29Z,2017-10-07T08:54:51Z,30,28,2,0.066666667,2,3,1,2,{'LD4': 1},1,2,{'LD4': 1},
11282,3,0.044117647,1,2017-09-08T01:49:41Z,2017-11-14T23:48:08Z,68,65,3,0.044117647,4,3,2,1,"{'LD4': 1, 'LD5': 1}",2,1,"{'LD4': 1, 'LD5': 1}","Build system,Windows"
11290,1,0.034482759,1,2017-09-08T19:42:27Z,2017-10-07T13:37:35Z,29,28,1,0.034482759,1,1,0,1,{},0,1,{},Resource usage
11302,3,0.051724138,1.5,2017-09-11T16:47:42Z,2017-11-07T17:26:29Z,58,56,2,0.034482759,3,3,3,0,"{'LD2': 1, 'LD3': 1, 'LD4': 1}",3,0,"{'LD2': 1, 'LD3': 1, 'LD4': 1}",macOS
11304,1,1,1,2017-09-11T20:50:25Z,2017-09-11T22:24:25Z,1,0,1,1,0,1,1,0,{'LD2': 1},1,0,{'LD2': 1},
11313,2,0.285714286,2,2017-09-12T21:52:36Z,2017-09-19T15:47:06Z,7,6,1,0.142857143,1,2,0,2,{},0,2,{},Wallet
11317,2,0.006097561,2,2017-09-13T04:01:57Z,2018-08-06T15:37:12Z,328,327,1,0.00304878,1,2,2,0,{'LD3': 2},2,0,{'LD3': 2},"Docs,Wallet"
11322,8,0.008359457,1.333333333,2017-09-13T17:01:08Z,2020-04-27T00:34:55Z,957,951,6,0.006269592,5,5,3,5,"{'LD3': 1, 'LD4': 2}",2,3,"{'LD3': 1, 'LD4': 2}",RPC/REST/ZMQ
11324,3,0.002461034,1.5,2017-09-13T18:22:15Z,2021-01-14T04:05:23Z,1219,1217,2,0.001640689,1,3,0,3,{},0,3,{},RPC/REST/ZMQ
11327,1,0.007575758,1,2017-09-14T13:52:12Z,2018-01-24T01:46:16Z,132,131,1,0.007575758,1,1,1,0,{'LD3': 1},1,0,{'LD3': 1},Bug
11336,1,1,1,2017-09-15T08:12:58Z,2017-09-15T14:06:26Z,1,0,1,1,0,1,0,1,{},0,1,{},"Docs,good first issue"
11344,3,0.037037037,1.5,2017-09-15T17:59:38Z,2017-12-05T07:30:59Z,81,79,2,0.024691358,3,3,1,2,{'LD5': 1},1,2,{'LD5': 1},"GUI,good first issue"
11348,10,0.15625,1.25,2017-09-16T06:17:54Z,2017-11-18T13:42:00Z,64,56,8,0.125,5,7,4,6,"{'LD1': 1, 'LD3': 1, 'LD6': 2}",4,3,"{'LD1': 1, 'LD3': 1, 'LD6': 2}",Wallet
11349,1,1,1,2017-09-16T06:23:26Z,2017-09-16T09:17:00Z,1,0,1,1,0,1,0,1,{},0,1,{},
11352,4,0.222222222,1.333333333,2017-09-16T10:23:29Z,2017-10-03T19:28:52Z,18,15,3,0.166666667,3,3,1,3,{'LD1': 1},1,2,{'LD1': 1},
11355,29,0.149484536,2.636363636,2017-09-16T19:59:33Z,2018-03-28T21:05:29Z,194,183,11,0.056701031,7,9,12,17,"{'LD3': 3, 'LD4': 4, 'LD1': 3, 'LD6': 1, 'LD5': 1}",7,2,"{'LD3': 3, 'LD4': 4, 'LD1': 3, 'LD6': 1, 'LD5': 1}",Data corruption
11356,6,0.15,2,2017-09-17T08:37:05Z,2017-10-26T21:51:22Z,40,37,3,0.075,2,4,3,3,{'LD4': 3},2,2,{'LD4': 2},GUI
11358,3,0.428571429,1.5,2017-09-17T19:20:48Z,2017-09-24T09:09:49Z,7,5,2,0.285714286,1,3,2,1,"{'LD1': 1, 'LD4': 1}",2,1,"{'LD1': 1, 'LD4': 1}",Linux/Unix
11364,4,0.444444444,1.333333333,2017-09-19T05:12:28Z,2017-09-27T07:50:07Z,9,6,3,0.333333333,2,3,2,2,"{'LD4': 1, 'LD6': 1}",2,1,"{'LD4': 1, 'LD6': 1}",Linux/Unix
11371,3,0.003151261,1,2017-09-20T00:47:57Z,2020-04-28T12:29:00Z,952,949,3,0.003151261,3,3,0,3,{},0,3,{},P2P
11373,2,2,2,2017-09-20T05:11:16Z,2017-09-20T16:47:57Z,1,0,1,1,0,2,1,1,{'LD5': 1},1,1,{'LD5': 1},
11382,7,0.4375,1.75,2017-09-21T21:45:33Z,2017-10-07T11:37:32Z,16,12,4,0.25,2,5,4,3,"{'LD6': 1, 'LD4': 2, 'LD5': 1}",4,1,"{'LD6': 1, 'LD4': 2, 'LD5': 1}",Questions and Help
11388,4,0.266666667,1,2017-09-23T02:16:37Z,2017-10-07T11:32:45Z,15,11,4,0.266666667,4,2,0,4,{},0,2,{},Build system
11405,1,0.5,1,2017-09-26T14:20:14Z,2017-09-28T02:51:39Z,2,1,1,0.5,1,1,0,1,{},0,1,{},
11409,6,6,6,2017-09-27T14:14:09Z,2017-09-27T21:28:52Z,1,0,1,1,0,3,4,2,"{'LD1': 1, 'LD4': 2, 'LD5': 1}",2,1,"{'LD1': 1, 'LD4': 2, 'LD5': 1}",macOS
11416,1,0.2,1,2017-09-29T04:59:20Z,2017-10-03T19:59:09Z,5,4,1,0.2,1,1,1,0,{'LD6': 1},1,0,{'LD6': 1},
11429,2,0.105263158,1,2017-09-30T16:47:55Z,2017-10-19T16:17:44Z,19,17,2,0.105263158,2,2,1,1,{'LD3': 1},1,1,{'LD3': 1},Wallet
11444,1,1,1,2017-10-03T12:38:32Z,2017-10-03T15:39:57Z,1,0,1,1,0,1,1,0,{'LD1': 1},1,0,{'LD1': 1},
11449,7,0.047945205,1.75,2017-10-04T13:47:30Z,2018-02-26T15:26:38Z,146,142,4,0.02739726,4,5,1,6,{'LD5': 1},1,4,{'LD5': 1},good first issue
11450,7,0.016129032,2.333333333,2017-10-04T14:22:04Z,2018-12-12T05:01:39Z,434,431,3,0.006912442,3,4,2,5,"{'LD3': 1, 'LD4': 1}",2,2,"{'LD3': 1, 'LD4': 1}",Wallet
11451,2,2,2,2017-10-04T16:14:09Z,2017-10-04T17:52:44Z,1,0,1,1,0,2,0,2,{},0,2,{},
11453,1,1,1,2017-10-05T00:42:29Z,2017-10-05T00:47:37Z,1,0,1,1,0,1,1,0,{'LD2': 1},1,0,{'LD2': 1},
11454,3,3,3,2017-10-05T09:08:46Z,2017-10-06T01:04:36Z,1,0,1,1,0,3,2,1,"{'LD4': 1, 'LD3': 1}",2,1,"{'LD4': 1, 'LD3': 1}",macOS
11459,1,1,1,2017-10-07T00:06:57Z,2017-10-07T14:39:59Z,1,0,1,1,0,1,0,1,{},0,1,{},Questions and Help
11461,4,0.026666667,1,2017-10-07T06:08:36Z,2018-03-05T19:43:38Z,150,146,4,0.026666667,5,4,2,2,{'LD3': 2},2,2,{'LD3': 2},"Build system,macOS"
11462,4,1.333333333,2,2017-10-07T08:43:01Z,2017-10-09T17:13:52Z,3,1,2,0.666666667,1,2,1,3,{'LD6': 1},1,1,{'LD6': 1},Docs
11464,2,0.002735978,2,2017-10-08T21:15:51Z,2019-10-09T18:35:39Z,731,730,1,0.001367989,1,1,0,2,{},0,1,{},GUI
11470,1,1,1,2017-10-09T18:57:39Z,2017-10-09T19:21:06Z,1,0,1,1,0,1,1,0,{'LD2': 1},1,0,{'LD2': 1},
11481,1,0.333333333,1,2017-10-11T06:55:39Z,2017-10-14T03:23:57Z,3,2,1,0.333333333,2,1,1,0,{'LD2': 1},1,0,{'LD2': 1},"Questions and Help,RPC/REST/ZMQ"
11500,4,4,4,2017-10-15T03:45:53Z,2017-10-15T08:11:58Z,1,0,1,1,0,1,2,2,"{'LD4': 1, 'LD1': 1}",1,0,"{'LD4': 1, 'LD1': 1}","RPC/REST/ZMQ,TX fees and policy"
11501,3,0.75,1.5,2017-10-15T05:53:11Z,2017-10-18T13:23:50Z,4,2,2,0.5,1,3,0,3,{},0,3,{},GUI
11502,7,7,7,2017-10-15T08:57:48Z,2017-10-16T01:48:21Z,1,0,1,1,0,3,3,4,"{'LD4': 2, 'LD1': 1}",3,0,"{'LD4': 2, 'LD1': 1}",RPC/REST/ZMQ
11503,1,1,1,2017-10-15T10:07:25Z,2017-10-16T05:36:03Z,1,0,1,1,0,1,1,0,{'LD2': 1},1,0,{'LD2': 1},
11505,1,1,1,2017-10-15T18:12:19Z,2017-10-15T20:32:17Z,1,0,1,1,0,1,0,1,{},0,1,{},
11506,8,1.6,4,2017-10-16T04:03:15Z,2017-10-21T03:14:20Z,5,3,2,0.4,1,3,4,4,"{'LD4': 3, 'LD3': 1}",2,1,"{'LD4': 2, 'LD3': 1}",RPC/REST/ZMQ
11519,2,2,2,2017-10-18T03:09:40Z,2017-10-18T14:40:30Z,1,0,1,1,0,2,1,1,{'LD2': 1},1,1,{'LD2': 1},
11520,1,1,1,2017-10-18T12:15:00Z,2017-10-19T09:14:24Z,1,0,1,1,0,1,1,0,{'LD1': 1},1,0,{'LD1': 1},Linux/Unix
11540,4,2,2,2017-10-21T03:25:02Z,2017-10-22T04:59:33Z,2,0,2,1,0,4,2,2,{'LD3': 2},2,2,{'LD3': 2},Linux/Unix
11544,1,1,1,2017-10-21T12:31:15Z,2017-10-21T18:15:26Z,1,0,1,1,0,1,0,1,{},0,1,{},Questions and Help
11546,1,1,1,2017-10-21T16:42:36Z,2017-10-21T16:58:47Z,1,0,1,1,0,1,0,1,{},0,1,{},
11548,1,1,1,2017-10-23T03:11:14Z,2017-10-23T08:14:17Z,1,0,1,1,0,1,1,0,{'LD2': 1},1,0,{'LD2': 1},Questions and Help
11549,11,0.47826087,3.666666667,2017-10-23T14:35:01Z,2017-11-14T23:45:51Z,23,20,3,0.130434783,2,4,5,6,"{'LD1': 1, 'LD4': 1, 'LD6': 1, 'LD3': 1, 'LD5': 1}",4,0,"{'LD1': 1, 'LD4': 1, 'LD6': 1, 'LD3': 1, 'LD5': 1}",Windows
11561,2,0.01242236,1,2017-10-25T20:24:46Z,2018-04-04T18:10:24Z,161,159,2,0.01242236,2,2,1,1,{'LD6': 1},1,1,{'LD6': 1},Tests
11564,8,0.0078125,1.6,2017-10-26T10:19:44Z,2020-08-15T02:24:18Z,1024,1019,5,0.004882813,5,7,2,6,"{'LD6': 1, 'LD3': 1}",2,5,"{'LD6': 1, 'LD3': 1}",GUI
11567,1,1,1,2017-10-26T15:41:15Z,2017-10-27T05:20:31Z,1,0,1,1,0,1,0,1,{},0,1,{},
11569,2,2,2,2017-10-26T23:19:02Z,2017-10-27T21:08:53Z,1,0,1,1,0,2,2,0,"{'LD1': 1, 'LD5': 1}",2,0,"{'LD1': 1, 'LD5': 1}",macOS
11574,1,0.25,1,2017-10-29T05:57:17Z,2017-11-01T07:08:05Z,4,3,1,0.25,1,1,1,0,{'LD1': 1},1,0,{'LD1': 1},"Docs,RPC/REST/ZMQ"
11575,2,0.4,1,2017-10-29T17:59:49Z,2017-11-02T19:53:43Z,5,3,2,0.4,2,1,1,1,{'LD2': 1},1,0,{'LD2': 1},"Questions and Help,Wallet"
11576,2,0.333333333,2,2017-10-29T19:10:43Z,2017-11-03T22:50:33Z,6,5,1,0.166666667,1,2,0,2,{},0,2,{},Questions and Help
11581,10,0.067114094,2,2017-10-30T18:39:19Z,2018-03-27T21:46:11Z,149,144,5,0.033557047,2,7,4,6,"{'LD3': 2, 'LD4': 1, 'LD5': 1}",4,3,"{'LD3': 2, 'LD4': 1, 'LD5': 1}",GUI
11584,3,0.2,1,2017-10-31T01:21:20Z,2017-11-14T23:46:05Z,15,12,3,0.2,3,3,2,1,"{'LD5': 1, 'LD3': 1}",2,1,"{'LD5': 1, 'LD3': 1}",Windows
11586,2,1,2,2017-10-31T15:52:27Z,2017-11-01T16:08:04Z,2,1,1,0.5,1,1,2,0,{'LD1': 2},1,0,{'LD1': 1},RPC/REST/ZMQ
11588,3,1.5,3,2017-10-31T22:27:31Z,2017-11-02T17:02:53Z,2,1,1,0.5,1,1,3,0,"{'LD1': 1, 'LD3': 1, 'LD2': 1}",1,0,"{'LD1': 1, 'LD3': 1, 'LD2': 1}","Docs,RPC/REST/ZMQ"
11589,6,0.006521739,3,2017-11-01T01:19:43Z,2020-05-08T20:05:11Z,920,918,2,0.002173913,2,3,0,6,{},0,3,{},"RPC/REST/ZMQ,Wallet"
11601,5,0.025641026,1.666666667,2017-11-03T17:12:59Z,2018-05-17T13:07:02Z,195,192,3,0.015384615,2,4,1,4,{'LD4': 1},1,3,{'LD4': 1},Linux/Unix
11606,12,0.062176166,2.4,2017-11-04T13:09:52Z,2018-05-15T16:00:06Z,193,188,5,0.025906736,4,9,4,8,"{'LD3': 1, 'LD5': 3}",3,6,"{'LD3': 1, 'LD5': 2}",GUI
11608,4,0.003421728,1,2017-11-04T21:05:20Z,2021-01-16T05:01:18Z,1169,1165,4,0.003421728,2,4,4,0,"{'LD3': 3, 'LD2': 1}",4,0,"{'LD3': 3, 'LD2': 1}",P2P
11609,1,1,1,2017-11-05T03:08:34Z,2017-11-05T04:39:34Z,1,0,1,1,0,1,1,0,{'LD2': 1},1,0,{'LD2': 1},
11612,5,0.125,1.666666667,2017-11-05T16:59:43Z,2017-12-15T09:44:27Z,40,37,3,0.075,2,4,3,2,"{'LD2': 1, 'LD3': 2}",3,1,"{'LD2': 1, 'LD3': 2}",P2P
11613,6,0.006550218,1.5,2017-11-05T19:06:40Z,2020-05-09T12:31:56Z,916,912,4,0.004366812,4,4,3,3,"{'LD3': 1, 'LD4': 1, 'LD5': 1}",3,1,"{'LD3': 1, 'LD4': 1, 'LD5': 1}",RPC/REST/ZMQ
11627,5,0.625,1.666666667,2017-11-07T07:17:40Z,2017-11-14T18:00:09Z,8,5,3,0.375,2,4,2,3,{'LD5': 2},2,2,{'LD5': 2},"Data corruption,Linux/Unix"
11631,1,0.020833333,1,2017-11-08T01:06:11Z,2017-12-25T15:00:58Z,48,47,1,0.020833333,2,1,0,1,{},0,1,{},"Docs,RPC/REST/ZMQ"
11632,24,0.169014085,2.666666667,2017-11-08T05:53:54Z,2018-03-29T23:45:22Z,142,133,9,0.063380282,5,7,6,18,"{'LD1': 2, 'LD3': 3, 'LD4': 1}",3,4,"{'LD1': 1, 'LD3': 2, 'LD4': 1}",Tests
11633,1,0.333333333,1,2017-11-08T07:53:50Z,2017-11-11T07:46:43Z,3,2,1,0.333333333,1,1,1,0,{'LD4': 1},1,0,{'LD4': 1},"Build system,Windows"
11636,2,2,2,2017-11-08T10:55:21Z,2017-11-08T23:54:21Z,1,0,1,1,0,1,2,0,{'LD1': 2},1,0,{'LD1': 1},Tests
11642,4,0.004381161,2,2017-11-09T10:28:05Z,2020-05-09T12:30:40Z,913,911,2,0.002190581,2,4,3,1,"{'LD1': 2, 'LD3': 1}",3,1,"{'LD1': 2, 'LD3': 1}","Brainstorming,GUI,Wallet"
11645,13,0.09352518,3.25,2017-11-09T16:21:46Z,2018-03-27T22:11:42Z,139,135,4,0.028776978,2,5,4,9,"{'LD3': 3, 'LD5': 1}",4,1,"{'LD3': 3, 'LD5': 1}","GUI,macOS"
11656,3,3,3,2017-11-10T20:54:02Z,2017-11-11T00:25:02Z,1,0,1,1,0,2,1,2,{'LD4': 1},1,1,{'LD4': 1},
11657,2,0.017241379,1,2017-11-11T08:03:48Z,2018-03-06T21:43:45Z,116,114,2,0.017241379,3,1,1,1,{'LD1': 1},1,0,{'LD1': 1},"Build system,Windows"
11659,2,0.666666667,1,2017-11-11T09:22:21Z,2017-11-13T11:49:27Z,3,1,2,0.666666667,1,2,0,2,{},0,2,{},Windows
11661,3,0.021428571,1,2017-11-11T13:36:24Z,2018-03-30T14:05:40Z,140,137,3,0.021428571,2,3,2,1,{'LD2': 2},2,1,{'LD2': 2},GUI
11668,6,0.045454545,2,2017-11-12T09:45:28Z,2018-03-23T19:25:58Z,132,129,3,0.022727273,1,3,3,3,"{'LD1': 2, 'LD3': 1}",3,0,"{'LD1': 2, 'LD3': 1}",Windows
11671,2,2,2,2017-11-12T17:15:10Z,2017-11-13T07:34:32Z,1,0,1,1,0,2,0,2,{},0,2,{},
11685,7,2.333333333,7,2017-11-14T16:57:51Z,2017-11-17T15:21:24Z,3,2,1,0.333333333,1,6,4,3,"{'LD3': 2, 'LD1': 2}",3,3,"{'LD3': 1, 'LD1': 2}","Build system,Docs,Windows,good first issue"
11688,1,1,1,2017-11-14T20:39:05Z,2017-11-14T20:50:28Z,1,0,1,1,0,1,0,1,{},0,1,{},
11693,1,0.002994012,1,2017-11-15T13:17:08Z,2018-10-15T04:36:09Z,334,333,1,0.002994012,1,1,1,0,{'LD3': 1},1,0,{'LD3': 1},RPC/REST/ZMQ
11695,2,2,2,2017-11-15T17:24:26Z,2017-11-15T21:29:07Z,1,0,1,1,0,2,1,1,{'LD1': 1},1,1,{'LD1': 1},
11696,4,0.004716981,1.333333333,2017-11-15T18:20:42Z,2020-03-12T13:16:17Z,848,845,3,0.003537736,4,2,0,4,{},0,2,{},Tests
11715,2,2,2,2017-11-18T10:06:47Z,2017-11-18T14:48:56Z,1,0,1,1,0,1,2,0,"{'LD2': 1, 'LD3': 1}",1,0,"{'LD2': 1, 'LD3': 1}",RPC/REST/ZMQ
11716,8,0.061538462,2.666666667,2017-11-18T11:54:14Z,2018-03-28T09:09:42Z,130,127,3,0.023076923,2,4,2,6,"{'LD3': 1, 'LD5': 1}",2,2,"{'LD3': 1, 'LD5': 1}","RPC/REST/ZMQ,Wallet"
11721,1,0.333333333,1,2017-11-18T16:35:09Z,2017-11-21T07:51:44Z,3,2,1,0.333333333,1,1,0,1,{},0,1,{},"GUI,RPC/REST/ZMQ"
11724,2,0.4,2,2017-11-18T20:25:53Z,2017-11-23T15:35:57Z,5,4,1,0.2,1,2,0,2,{},0,2,{},Questions and Help
11725,5,0.04587156,1.25,2017-11-18T20:56:17Z,2018-03-06T22:18:30Z,109,105,4,0.036697248,1,2,2,3,"{'LD1': 1, 'LD4': 1}",1,1,"{'LD1': 1, 'LD4': 1}","Resource usage,macOS"
11727,1,0.25,1,2017-11-19T11:51:30Z,2017-11-22T20:15:06Z,4,3,1,0.25,1,1,1,0,{'LD4': 1},1,0,{'LD4': 1},GUI
11731,7,0.046357616,1.4,2017-11-20T05:48:49Z,2018-04-20T02:08:35Z,151,146,5,0.033112583,3,4,4,3,"{'LD4': 2, 'LD5': 2}",3,1,"{'LD4': 2, 'LD5': 2}",macOS
11732,7,2.333333333,2.333333333,2017-11-20T09:12:51Z,2017-11-23T07:42:11Z,3,0,3,1,0,5,5,2,"{'LD2': 1, 'LD3': 2, 'LD5': 1, 'LD6': 1}",4,1,"{'LD2': 1, 'LD3': 2, 'LD5': 1, 'LD6': 1}",Build system
11736,3,0.0234375,1.5,2017-11-20T16:03:05Z,2018-03-27T22:05:12Z,128,126,2,0.015625,1,3,2,1,"{'LD1': 1, 'LD5': 1}",2,1,"{'LD1': 1, 'LD5': 1}","Block storage,Questions and Help"
11745,2,0.25,1,2017-11-21T16:53:27Z,2017-11-29T11:00:05Z,8,6,2,0.25,1,2,1,1,{'LD2': 1},1,1,{'LD2': 1},Bug
11752,4,4,4,2017-11-22T17:46:29Z,2017-11-23T15:34:02Z,1,0,1,1,0,2,2,2,"{'LD1': 1, 'LD2': 1}",2,0,"{'LD1': 1, 'LD2': 1}",Questions and Help
11757,4,0.266666667,2,2017-11-23T08:19:08Z,2017-12-08T02:00:46Z,15,13,2,0.133333333,1,2,0,4,{},0,2,{},P2P
11758,1,1,1,2017-11-23T14:38:06Z,2017-11-23T15:33:09Z,1,0,1,1,0,1,0,1,{},0,1,{},Questions and Help
11763,1,1,1,2017-11-25T06:40:03Z,2017-11-25T07:03:25Z,1,0,1,1,0,1,1,0,{'LD4': 1},1,0,{'LD4': 1},
11767,6,6,6,2017-11-25T10:24:05Z,2017-11-26T05:08:56Z,1,0,1,1,0,2,3,3,"{'LD1': 2, 'LD4': 1}",2,0,"{'LD1': 2, 'LD4': 1}",macOS
11768,3,0.045454545,3,2017-11-25T13:26:11Z,2018-01-29T13:26:34Z,66,65,1,0.015151515,1,2,0,3,{},0,2,{},Questions and Help
11769,7,0.007829978,2.333333333,2017-11-27T03:25:27Z,2020-05-08T20:05:43Z,894,891,3,0.003355705,3,3,4,3,"{'LD4': 2, 'LD1': 2}",3,0,"{'LD4': 2, 'LD1': 2}",P2P
11777,10,0.026737968,1.428571429,2017-11-27T21:20:17Z,2018-12-06T16:45:54Z,374,367,7,0.018716578,5,6,1,9,{'LD3': 1},1,5,{'LD3': 1},Tests
11778,1,0.008130081,1,2017-11-27T21:29:46Z,2018-03-30T15:58:33Z,123,122,1,0.008130081,2,1,1,0,{'LD3': 1},1,0,{'LD3': 1},Tests
11782,3,0.003405221,3,2017-11-28T10:41:36Z,2020-04-27T00:39:04Z,881,880,1,0.001135074,1,2,1,2,{'LD2': 1},1,1,{'LD2': 1},Validation
11786,1,1,1,2017-11-29T09:32:18Z,2017-11-29T10:21:25Z,1,0,1,1,0,1,1,0,{'LD2': 1},1,0,{'LD2': 1},
11788,9,0.02238806,1.285714286,2017-11-29T17:35:19Z,2019-01-04T22:02:16Z,402,395,7,0.017412935,4,5,4,5,"{'LD4': 2, 'LD3': 1, 'LD1': 1}",3,2,"{'LD4': 2, 'LD3': 1, 'LD1': 1}","GUI,good first issue"
11798,3,3,3,2017-11-30T11:34:21Z,2017-11-30T15:18:09Z,1,0,1,1,0,1,2,1,"{'LD4': 1, 'LD2': 1}",1,0,"{'LD4': 1, 'LD2': 1}",
11801,1,0.125,1,2017-11-30T16:16:58Z,2017-12-07T22:29:38Z,8,7,1,0.125,1,1,1,0,{'LD2': 1},1,0,{'LD2': 1},
11805,1,1,1,2017-12-01T02:15:40Z,2017-12-01T15:15:47Z,1,0,1,1,0,1,1,0,{'LD1': 1},1,0,{'LD1': 1},Build system
11810,2,0.020833333,2,2017-12-01T12:48:51Z,2018-03-06T20:17:02Z,96,95,1,0.010416667,1,2,1,1,{'LD1': 1},1,1,{'LD1': 1},
11811,5,0.013586957,1.666666667,2017-12-01T15:14:46Z,2018-12-04T08:21:24Z,368,365,3,0.008152174,3,5,2,3,"{'LD3': 1, 'LD4': 1}",2,3,"{'LD3': 1, 'LD4': 1}",GUI
11812,5,0.005701254,2.5,2017-12-01T17:42:33Z,2020-04-26T01:20:21Z,877,875,2,0.002280502,2,2,2,3,"{'LD4': 1, 'LD3': 1}",1,1,"{'LD4': 1, 'LD3': 1}",Windows
11814,2,0.333333333,2,2017-12-02T01:30:23Z,2017-12-07T18:04:33Z,6,5,1,0.166666667,2,1,1,1,{'LD1': 1},1,0,{'LD1': 1},Windows
11816,4,0.037735849,1.333333333,2017-12-02T11:29:00Z,2018-03-17T16:22:07Z,106,103,3,0.028301887,3,4,4,0,"{'LD4': 2, 'LD3': 1, 'LD2': 1}",4,0,"{'LD4': 2, 'LD3': 1, 'LD2': 1}","Data corruption,Linux/Unix"
11819,3,0.028571429,1,2017-12-02T19:01:52Z,2018-03-17T05:46:03Z,105,102,3,0.028571429,3,2,1,2,{'LD5': 1},1,1,{'LD5': 1},
11820,2,0.133333333,1,2017-12-03T15:48:47Z,2017-12-17T15:51:11Z,15,13,2,0.133333333,2,2,2,0,{'LD4': 2},2,0,{'LD4': 2},
11822,9,0.346153846,2.25,2017-12-04T08:27:41Z,2017-12-29T09:52:09Z,26,22,4,0.153846154,4,5,0,9,{},0,5,{},Resource usage
11823,1,1,1,2017-12-04T10:23:45Z,2017-12-04T20:29:33Z,1,0,1,1,0,1,0,1,{},0,1,{},
11825,3,0.032258065,1.5,2017-12-05T00:37:51Z,2018-03-07T18:44:04Z,93,91,2,0.021505376,1,2,3,0,"{'LD4': 1, 'LD1': 1, 'LD2': 1}",2,0,"{'LD4': 1, 'LD1': 1, 'LD2': 1}",Linux/Unix
11826,9,0.009146341,2.25,2017-12-05T02:14:02Z,2020-08-14T10:09:04Z,984,980,4,0.004065041,4,6,4,5,"{'LD3': 3, 'LD1': 1}",3,3,"{'LD3': 3, 'LD1': 1}","Feature,GUI"
11827,9,0.012145749,3,2017-12-05T07:28:29Z,2019-12-15T09:26:18Z,741,738,3,0.004048583,3,5,4,5,"{'LD4': 2, 'LD1': 1, 'LD5': 1}",3,2,"{'LD4': 2, 'LD1': 1, 'LD5': 1}","GUI,Questions and Help"
11828,4,0.018691589,4,2017-12-05T08:44:45Z,2018-07-06T11:33:25Z,214,213,1,0.004672897,1,2,0,4,{},0,2,{},
11832,5,5,5,2017-12-05T16:33:13Z,2017-12-05T22:38:06Z,1,0,1,1,0,3,3,2,"{'LD1': 1, 'LD3': 1, 'LD4': 1}",2,1,"{'LD1': 1, 'LD3': 1, 'LD4': 1}",
11833,16,0.058181818,5.333333333,2017-12-05T17:37:44Z,2018-09-06T02:21:43Z,275,272,3,0.010909091,3,6,5,11,"{'LD3': 1, 'LD1': 3, 'LD5': 1}",4,2,"{'LD3': 1, 'LD1': 2, 'LD5': 1}",
11840,2,0.028985507,2,2017-12-06T17:16:28Z,2018-02-13T13:14:47Z,69,68,1,0.014492754,1,1,0,2,{},0,1,{},GUI
11844,23,0.0260181,1.533333333,2017-12-07T12:02:01Z,2020-05-08T22:27:47Z,884,869,15,0.016968326,10,8,6,17,"{'LD1': 1, 'LD4': 4, 'LD5': 1}",4,4,"{'LD1': 1, 'LD4': 2, 'LD5': 1}","Android,Build system"
11848,4,0.086956522,2,2017-12-07T15:36:52Z,2018-01-22T08:22:10Z,46,44,2,0.043478261,3,3,2,2,"{'LD4': 1, 'LD1': 1}",2,1,"{'LD4': 1, 'LD1': 1}",RPC/REST/ZMQ
11850,2,0.02,1,2017-12-08T09:44:19Z,2018-03-17T20:28:59Z,100,98,2,0.02,2,2,1,1,{'LD4': 1},1,1,{'LD4': 1},"Build system,Questions and Help"
11852,2,2,2,2017-12-08T12:51:50Z,2017-12-08T16:32:36Z,1,0,1,1,0,2,1,1,{'LD1': 1},1,1,{'LD1': 1},
11855,3,0.033707865,1,2017-12-08T18:03:16Z,2018-03-06T22:01:46Z,89,86,3,0.033707865,3,3,2,1,{'LD3': 2},2,1,{'LD3': 2},Linux/Unix
11861,3,0.09375,3,2017-12-11T05:24:43Z,2018-01-11T13:17:19Z,32,31,1,0.03125,1,3,1,2,{'LD3': 1},1,2,{'LD3': 1},RPC/REST/ZMQ
11863,11,0.021782178,1.833333333,2017-12-11T13:57:00Z,2019-04-29T19:44:26Z,505,499,6,0.011881188,5,7,3,8,"{'LD4': 1, 'LD3': 2}",3,4,"{'LD4': 1, 'LD3': 2}",Brainstorming
11868,1,0.002369668,1,2017-12-11T20:14:31Z,2019-02-06T15:24:40Z,422,421,1,0.002369668,2,1,0,1,{},0,1,{},Linux/Unix
11873,4,0.08,4,2017-12-12T01:42:13Z,2018-01-30T09:28:45Z,50,49,1,0.02,2,3,0,4,{},0,3,{},
11874,3,0.011152416,1.5,2017-12-12T06:03:47Z,2018-09-06T07:17:03Z,269,267,2,0.007434944,2,2,3,0,"{'LD2': 1, 'LD4': 1, 'LD5': 1}",2,0,"{'LD2': 1, 'LD4': 1, 'LD5': 1}",
11875,6,0.013793103,6,2017-12-12T11:41:27Z,2019-02-19T13:07:32Z,435,434,1,0.002298851,1,5,2,4,"{'LD4': 1, 'LD3': 1}",1,4,"{'LD4': 1, 'LD3': 1}","Brainstorming,GUI"
11888,1,0.029411765,1,2017-12-13T20:13:23Z,2018-01-16T10:12:57Z,34,33,1,0.029411765,1,1,1,0,{'LD1': 1},1,0,{'LD1': 1},Wallet
11890,1,0.5,1,2017-12-13T20:56:46Z,2017-12-15T16:00:33Z,2,1,1,0.5,1,1,1,0,{'LD2': 1},1,0,{'LD2': 1},
11893,4,4,4,2017-12-14T01:41:53Z,2017-12-14T18:58:44Z,1,0,1,1,0,3,2,2,"{'LD2': 1, 'LD3': 1}",2,1,"{'LD2': 1, 'LD3': 1}",RPC/REST/ZMQ
11896,2,0.003759398,1,2017-12-14T10:13:25Z,2019-05-29T21:50:02Z,532,530,2,0.003759398,3,1,0,2,{},0,1,{},macOS
11899,1,1,1,2017-12-14T15:28:35Z,2017-12-14T15:38:46Z,1,0,1,1,0,1,1,0,{'LD4': 1},1,0,{'LD4': 1},
11901,4,0.033613445,2,2017-12-14T20:01:43Z,2018-04-11T20:11:13Z,119,117,2,0.016806723,2,2,2,2,"{'LD3': 1, 'LD6': 1}",2,0,"{'LD3': 1, 'LD6': 1}","Build system,Tests"
11902,2,0.001785714,1,2017-12-14T20:22:48Z,2021-01-07T18:42:32Z,1120,1118,2,0.001785714,2,2,1,1,{'LD6': 1},1,1,{'LD6': 1},"P2P,good first issue"
11906,1,1,1,2017-12-15T11:33:45Z,2017-12-15T16:24:17Z,1,0,1,1,0,1,0,1,{},0,1,{},macOS
11914,2,1,1,2017-12-15T22:31:42Z,2017-12-17T21:41:35Z,2,0,2,1,0,1,1,1,{'LD4': 1},1,0,{'LD4': 1},"Data corruption,Questions and Help"
11919,1,1,1,2017-12-17T00:17:45Z,2017-12-17T00:22:01Z,1,0,1,1,0,1,0,1,{},0,1,{},
11922,2,0.025,1,2017-12-17T15:48:20Z,2018-03-06T22:18:25Z,80,78,2,0.025,2,2,2,0,{'LD1': 2},2,0,{'LD1': 2},"Build system,macOS"
11932,1,1,1,2017-12-17T18:25:18Z,2017-12-17T18:55:11Z,1,0,1,1,0,1,1,0,{'LD2': 1},1,0,{'LD2': 1},
11933,1,1,1,2017-12-17T21:58:05Z,2017-12-17T22:01:14Z,1,0,1,1,0,1,1,0,{'LD2': 1},1,0,{'LD2': 1},
11934,1,0.00116144,1,2017-12-17T22:06:11Z,2020-04-26T01:21:55Z,861,860,1,0.00116144,1,1,1,0,{'LD4': 1},1,0,{'LD4': 1},RPC/REST/ZMQ
11935,1,0.04,1,2017-12-18T01:13:02Z,2018-01-11T19:04:35Z,25,24,1,0.04,1,1,1,0,{'LD4': 1},1,0,{'LD4': 1},"Build system,Linux/Unix"
11938,3,0.002657219,1,2017-12-18T15:35:31Z,2021-01-19T23:08:45Z,1129,1126,3,0.002657219,3,2,0,3,{},0,2,{},Block storage
11940,1,0.333333333,1,2017-12-18T22:03:55Z,2017-12-21T00:04:43Z,3,2,1,0.333333333,1,1,1,0,{'LD1': 1},1,0,{'LD1': 1},"Data corruption,Questions and Help"
11941,1,1,1,2017-12-19T03:21:51Z,2017-12-19T12:22:15Z,1,0,1,1,0,1,1,0,{'LD4': 1},1,0,{'LD4': 1},Questions and Help
11942,2,2,2,2017-12-19T03:43:25Z,2017-12-19T16:00:14Z,1,0,1,1,0,2,2,0,"{'LD1': 1, 'LD2': 1}",2,0,"{'LD1': 1, 'LD2': 1}",Questions and Help
11949,2,0.033333333,1,2017-12-19T14:48:27Z,2018-02-17T07:50:11Z,60,58,2,0.033333333,3,2,0,2,{},0,2,{},"Build system,Docs,good first issue"
11950,2,0.019047619,1,2017-12-19T15:42:00Z,2018-04-03T09:40:55Z,105,103,2,0.019047619,1,2,2,0,"{'LD3': 1, 'LD5': 1}",2,0,"{'LD3': 1, 'LD5': 1}",GUI
11953,1,0.043478261,1,2017-12-19T21:38:35Z,2018-01-11T13:48:27Z,23,22,1,0.043478261,1,1,1,0,{'LD4': 1},1,0,{'LD4': 1},Tests
11955,5,0.084745763,1.666666667,2017-12-20T01:14:10Z,2018-02-16T10:14:38Z,59,56,3,0.050847458,2,4,3,2,"{'LD4': 1, 'LD3': 1, 'LD5': 1}",3,1,"{'LD4': 1, 'LD3': 1, 'LD5': 1}","Mempool,Utils/log/libs,good first issue"
11961,2,0.021505376,1,2017-12-20T14:25:11Z,2018-03-22T21:59:35Z,93,91,2,0.021505376,2,2,1,1,{'LD1': 1},1,1,{'LD1': 1},"TX fees and policy,Wallet"
11964,12,0.013969732,1.714285714,2017-12-20T19:20:58Z,2020-04-27T00:43:15Z,859,852,7,0.00814901,7,6,5,7,"{'LD6': 3, 'LD4': 1, 'LD3': 1}",3,3,"{'LD6': 2, 'LD4': 1, 'LD3': 1}",Tests
11972,1,1,1,2017-12-21T15:07:50Z,2017-12-21T15:58:25Z,1,0,1,1,0,1,1,0,{'LD3': 1},1,0,{'LD3': 1},Wallet
11973,2,0.025,2,2017-12-21T16:04:01Z,2018-03-11T07:38:24Z,80,79,1,0.0125,1,2,2,0,"{'LD2': 1, 'LD1': 1}",2,0,"{'LD2': 1, 'LD1': 1}",TX fees and policy
11975,1,1,1,2017-12-21T21:27:56Z,2017-12-22T00:39:09Z,1,0,1,1,0,1,0,1,{},0,1,{},
11982,1,0.013333333,1,2017-12-22T01:33:48Z,2018-03-06T18:39:22Z,75,74,1,0.013333333,1,1,0,1,{},0,1,{},Build system
11992,3,0.003500583,1,2017-12-22T22:46:09Z,2020-04-27T00:41:27Z,857,854,3,0.003500583,3,2,3,0,{'LD4': 3},2,0,{'LD4': 2},TX fees and policy
11996,2,2,2,2017-12-23T04:14:34Z,2017-12-23T14:21:54Z,1,0,1,1,0,1,1,1,{'LD4': 1},1,0,{'LD4': 1},macOS
11998,1,1,1,2017-12-23T14:50:29Z,2017-12-23T17:19:54Z,1,0,1,1,0,1,0,1,{},0,1,{},
11999,2,0.019607843,1,2017-12-23T14:52:15Z,2018-04-04T13:26:45Z,102,100,2,0.019607843,3,2,1,1,{'LD4': 1},1,1,{'LD4': 1},"TX fees and policy,Up for grabs"
12004,2,2,2,2017-12-24T08:57:29Z,2017-12-24T12:43:22Z,1,0,1,1,0,2,1,1,{'LD2': 1},1,1,{'LD2': 1},macOS
12009,4,0.181818182,1.333333333,2017-12-24T15:47:38Z,2018-01-15T14:00:40Z,22,19,3,0.136363636,1,3,3,1,"{'LD3': 2, 'LD2': 1}",3,0,"{'LD3': 2, 'LD2': 1}",macOS
12011,1,0.00390625,1,2017-12-24T18:10:39Z,2018-09-06T02:24:38Z,256,255,1,0.00390625,2,1,1,0,{'LD3': 1},1,0,{'LD3': 1},
12014,3,0.050847458,1,2017-12-25T07:25:32Z,2018-02-21T23:11:07Z,59,56,3,0.050847458,2,3,1,2,{'LD1': 1},1,2,{'LD1': 1},macOS
12015,1,0.083333333,1,2017-12-25T10:51:46Z,2018-01-05T21:41:26Z,12,11,1,0.083333333,2,1,0,1,{},0,1,{},GUI
12016,2,0.5,1,2017-12-25T11:24:12Z,2017-12-28T23:23:58Z,4,2,2,0.5,2,2,2,0,"{'LD4': 1, 'LD3': 1}",2,0,"{'LD4': 1, 'LD3': 1}",
12017,1,0.009174312,1,2017-12-25T11:37:14Z,2018-04-12T20:49:34Z,109,108,1,0.009174312,1,1,0,1,{},0,1,{},Linux/Unix
12025,3,3,3,2017-12-26T13:15:13Z,2017-12-27T07:12:54Z,1,0,1,1,0,2,2,1,"{'LD1': 1, 'LD5': 1}",2,0,"{'LD1': 1, 'LD5': 1}",GUI
12030,1,0.011494253,1,2017-12-26T18:36:45Z,2018-03-22T21:15:48Z,87,86,1,0.011494253,2,1,0,1,{},0,1,{},Linux/Unix
12031,5,0.006493506,1.666666667,2017-12-27T04:19:35Z,2020-02-05T03:41:42Z,770,767,3,0.003896104,3,5,1,4,{'LD4': 1},1,4,{'LD4': 1},GUI
12033,1,0.001173709,1,2017-12-27T11:43:37Z,2020-04-26T22:26:44Z,852,851,1,0.001173709,2,1,1,0,{'LD2': 1},1,0,{'LD2': 1},Brainstorming
12037,1,1,1,2017-12-27T21:44:33Z,2017-12-27T22:41:04Z,1,0,1,1,0,1,0,1,{},0,1,{},
12038,1,0.014492754,1,2017-12-27T23:34:34Z,2018-03-06T18:04:33Z,69,68,1,0.014492754,2,1,1,0,{'LD2': 1},1,0,{'LD2': 1},Data corruption
12044,3,3,3,2017-12-28T22:19:42Z,2017-12-29T10:25:09Z,1,0,1,1,0,2,1,2,{'LD5': 1},1,1,{'LD5': 1},GUI
12047,6,0.214285714,1.2,2017-12-29T05:37:58Z,2018-01-25T06:01:07Z,28,23,5,0.178571429,3,5,4,2,"{'LD4': 1, 'LD2': 1, 'LD3': 1, 'LD1': 1}",4,1,"{'LD4': 1, 'LD2': 1, 'LD3': 1, 'LD1': 1}","Build system,Linux/Unix"
12049,4,0.004711425,1,2017-12-29T13:08:24Z,2020-04-26T01:23:15Z,849,845,4,0.004711425,4,4,1,3,{'LD4': 1},1,3,{'LD4': 1},Build system
12057,1,1,1,2017-12-30T15:02:11Z,2017-12-30T15:04:16Z,1,0,1,1,0,1,0,1,{},0,1,{},
12058,4,0.005228758,1,2017-12-30T19:17:56Z,2020-02-03T03:35:32Z,765,761,4,0.005228758,5,4,0,4,{},0,4,{},"Resource usage,macOS"
12060,4,0.307692308,1,2017-12-31T01:18:08Z,2018-01-12T23:32:11Z,13,9,4,0.307692308,4,2,1,3,{'LD5': 1},1,1,{'LD5': 1},Tests
12066,1,0.023255814,1,2018-01-01T06:13:39Z,2018-02-13T06:04:27Z,43,42,1,0.023255814,1,1,1,0,{'LD4': 1},1,0,{'LD4': 1},Wallet
12084,2,0.014492754,2,2018-01-04T01:49:18Z,2018-05-21T07:47:01Z,138,137,1,0.007246377,1,2,1,1,{'LD3': 1},1,1,{'LD3': 1},Wallet
12090,9,1.285714286,1.5,2018-01-04T17:26:30Z,2018-01-10T18:08:00Z,7,1,6,0.857142857,1,2,5,4,"{'LD1': 3, 'LD4': 2}",2,0,"{'LD1': 1, 'LD4': 2}",
12100,10,0.833333333,10,2018-01-06T05:18:12Z,2018-01-17T11:16:53Z,12,11,1,0.083333333,1,1,2,8,{'LD3': 2},1,0,{'LD3': 1},Wallet
12106,3,3,3,2018-01-07T09:24:39Z,2018-01-07T11:27:39Z,1,0,1,1,0,2,2,1,"{'LD3': 1, 'LD2': 1}",2,0,"{'LD3': 1, 'LD2': 1}","Linux/Unix,Mempool"
12115,2,0.002347418,1,2018-01-08T08:59:19Z,2020-05-08T22:30:22Z,852,850,2,0.002347418,3,2,2,0,"{'LD5': 1, 'LD3': 1}",2,0,"{'LD5': 1, 'LD3': 1}",Wallet
12116,1,0.125,1,2018-01-08T18:07:52Z,2018-01-16T06:41:18Z,8,7,1,0.125,1,1,1,0,{'LD5': 1},1,0,{'LD5': 1},Linux/Unix
12117,1,1,1,2018-01-08T18:24:25Z,2018-01-08T18:39:16Z,1,0,1,1,0,1,1,0,{'LD2': 1},1,0,{'LD2': 1},
12123,4,0.004750594,1,2018-01-08T22:01:12Z,2020-04-29T20:26:57Z,842,838,4,0.004750594,4,3,0,4,{},0,3,{},UTXO Db and Indexes
12126,3,0.214285714,1.5,2018-01-09T01:16:57Z,2018-01-22T20:15:19Z,14,12,2,0.142857143,1,2,2,1,"{'LD3': 1, 'LD1': 1}",2,0,"{'LD3': 1, 'LD1': 1}","Build system,macOS"
12129,8,0.4,1.6,2018-01-09T02:54:49Z,2018-01-28T16:17:43Z,20,15,5,0.25,4,5,5,3,"{'LD5': 3, 'LD2': 1, 'LD4': 1}",5,0,"{'LD5': 3, 'LD2': 1, 'LD4': 1}",Privacy
12142,2,0.025641026,1,2018-01-11T00:57:44Z,2018-03-29T22:27:20Z,78,76,2,0.025641026,2,2,2,0,"{'LD3': 1, 'LD4': 1}",2,0,"{'LD3': 1, 'LD4': 1}","Mempool,RPC/REST/ZMQ"
12144,1,0.083333333,1,2018-01-11T07:34:22Z,2018-01-22T08:57:59Z,12,11,1,0.083333333,2,1,0,1,{},0,1,{},Windows
12145,2,0.181818182,1,2018-01-11T10:27:37Z,2018-01-22T08:58:12Z,11,9,2,0.181818182,2,2,1,1,{'LD1': 1},1,1,{'LD1': 1},
12170,4,0.222222222,1.333333333,2018-01-12T12:27:52Z,2018-01-29T13:27:19Z,18,15,3,0.166666667,2,4,1,3,{'LD1': 1},1,3,{'LD1': 1},Questions and Help
12176,5,0.06097561,1.25,2018-01-13T11:23:21Z,2018-04-04T15:45:46Z,82,78,4,0.048780488,3,3,3,2,"{'LD4': 1, 'LD3': 1, 'LD5': 1}",3,0,"{'LD4': 1, 'LD3': 1, 'LD5': 1}",Block storage
12178,3,3,3,2018-01-13T17:47:47Z,2018-01-13T22:08:45Z,1,0,1,1,0,3,1,2,{'LD3': 1},1,2,{'LD3': 1},
12185,1,1,1,2018-01-14T22:18:51Z,2018-01-14T23:10:58Z,1,0,1,1,0,1,0,1,{},0,1,{},
12186,2,0.020833333,1,2018-01-14T23:37:03Z,2018-04-20T02:03:50Z,96,94,2,0.020833333,2,2,1,1,{'LD4': 1},1,1,{'LD4': 1},Linux/Unix
12191,6,0.012793177,2,2018-01-15T13:52:32Z,2019-04-29T07:05:59Z,469,466,3,0.006396588,2,2,2,4,{'LD1': 2},1,1,{'LD1': 1},GUI
12195,1,1,1,2018-01-16T06:59:41Z,2018-01-16T07:50:13Z,1,0,1,1,0,1,0,1,{},0,1,{},
12199,1,1,1,2018-01-16T12:54:50Z,2018-01-16T13:04:53Z,1,0,1,1,0,1,0,1,{},0,1,{},"Docs,Tests,good first issue"
12209,4,0.017167382,1,2018-01-17T10:36:59Z,2018-09-06T14:35:22Z,233,229,4,0.017167382,4,4,2,2,"{'LD1': 1, 'LD4': 1}",2,2,"{'LD1': 1, 'LD4': 1}","Questions and Help,RPC/REST/ZMQ"
12215,1,0.5,1,2018-01-18T05:15:40Z,2018-01-19T13:32:06Z,2,1,1,0.5,1,1,0,1,{},0,1,{},Block storage
12223,2,0.029411765,1,2018-01-19T08:28:20Z,2018-03-27T18:54:30Z,68,66,2,0.029411765,2,2,0,2,{},0,2,{},"RPC/REST/ZMQ,Utils/log/libs"
12224,1,0.5,1,2018-01-19T09:40:56Z,2018-01-20T18:27:02Z,2,1,1,0.5,1,1,1,0,{'LD1': 1},1,0,{'LD1': 1},RPC/REST/ZMQ
12229,1,0.090909091,1,2018-01-19T19:15:42Z,2018-01-30T12:05:29Z,11,10,1,0.090909091,1,1,0,1,{},0,1,{},
12230,5,0.106382979,2.5,2018-01-19T20:33:12Z,2018-03-06T22:02:52Z,47,45,2,0.042553191,2,2,1,4,{'LD4': 1},1,1,{'LD4': 1},"Data corruption,Questions and Help"
12233,2,2,2,2018-01-21T05:01:56Z,2018-01-21T05:19:31Z,1,0,1,1,0,2,0,2,{},0,2,{},
12239,1,1,1,2018-01-22T07:16:59Z,2018-01-22T09:53:03Z,1,0,1,1,0,1,1,0,{'LD2': 1},1,0,{'LD2': 1},
12253,5,0.017793594,1,2018-01-23T22:48:42Z,2018-10-31T16:46:14Z,281,276,5,0.017793594,3,4,1,4,{'LD2': 1},1,3,{'LD2': 1},RPC/REST/ZMQ
12256,6,0.009852217,1.5,2018-01-24T05:59:45Z,2019-09-24T13:58:57Z,609,605,4,0.006568144,4,3,3,3,"{'LD4': 2, 'LD2': 1}",2,1,"{'LD4': 1, 'LD2': 1}",Linux/Unix
12263,1,0.023809524,1,2018-01-24T16:51:18Z,2018-03-06T21:41:41Z,42,41,1,0.023809524,2,1,1,0,{'LD4': 1},1,0,{'LD4': 1},Build system
12272,1,0.5,1,2018-01-25T22:44:40Z,2018-01-27T17:18:03Z,2,1,1,0.5,1,1,1,0,{'LD4': 1},1,0,{'LD4': 1},"Build system,Questions and Help"
12279,5,0.128205128,1.666666667,2018-01-27T09:59:15Z,2018-03-06T18:06:00Z,39,36,3,0.076923077,3,5,2,3,{'LD4': 2},2,3,{'LD4': 2},Linux/Unix
12285,2,0.25,1,2018-01-28T11:23:02Z,2018-02-04T18:23:05Z,8,6,2,0.25,3,2,2,0,"{'LD3': 1, 'LD5': 1}",2,0,"{'LD3': 1, 'LD5': 1}",Linux/Unix
12289,1,1,1,2018-01-28T21:25:41Z,2018-01-29T21:07:54Z,1,0,1,1,0,1,0,1,{},0,1,{},"Questions and Help,RPC/REST/ZMQ"
12307,1,1,1,2018-01-31T02:21:36Z,2018-01-31T03:16:31Z,1,0,1,1,0,1,0,1,{},0,1,{},
12312,3,1.5,1.5,2018-01-31T15:35:18Z,2018-02-01T19:54:41Z,2,0,2,1,0,3,2,1,"{'LD3': 1, 'LD4': 1}",2,1,"{'LD3': 1, 'LD4': 1}",GUI
12318,2,0.05,1,2018-01-31T22:23:43Z,2018-03-11T22:34:29Z,40,38,2,0.05,3,2,2,0,"{'LD4': 1, 'LD1': 1}",2,0,"{'LD4': 1, 'LD1': 1}",macOS
12320,10,0.303030303,3.333333333,2018-01-31T23:37:30Z,2018-03-05T20:40:28Z,33,30,3,0.090909091,2,5,2,8,"{'LD4': 1, 'LD5': 1}",2,3,"{'LD4': 1, 'LD5': 1}",
12323,2,2,2,2018-02-01T11:26:46Z,2018-02-02T09:21:24Z,1,0,1,1,0,2,1,1,{'LD2': 1},1,1,{'LD2': 1},Resource usage
12328,1,1,1,2018-02-01T17:12:00Z,2018-02-02T09:20:30Z,1,0,1,1,0,1,0,1,{},0,1,{},
12332,1,0.012987013,1,2018-02-02T11:41:16Z,2018-04-20T02:04:55Z,77,76,1,0.012987013,2,1,0,1,{},0,1,{},Linux/Unix
12334,1,1,1,2018-02-02T14:40:18Z,2018-02-03T08:39:49Z,1,0,1,1,0,1,0,1,{},0,1,{},macOS
12335,1,0.001228501,1,2018-02-02T17:34:39Z,2020-04-26T01:23:53Z,814,813,1,0.001228501,2,1,0,1,{},0,1,{},RPC/REST/ZMQ
12337,6,0.016260163,1,2018-02-02T20:50:24Z,2019-02-06T15:27:19Z,369,363,6,0.016260163,4,4,3,3,"{'LD2': 1, 'LD3': 2}",3,1,"{'LD2': 1, 'LD3': 2}",GUI
12338,1,0.03030303,1,2018-02-02T21:09:26Z,2018-03-06T21:42:47Z,33,32,1,0.03030303,2,1,1,0,{'LD1': 1},1,0,{'LD1': 1},Build system
12339,6,0.016713092,2,2018-02-02T21:12:56Z,2019-01-27T06:26:46Z,359,356,3,0.008356546,3,3,0,6,{},0,3,{},"Docs,RPC/REST/ZMQ"
12343,1,0.5,1,2018-02-03T12:52:55Z,2018-02-04T18:25:39Z,2,1,1,0.5,1,1,0,1,{},0,1,{},P2P
12346,1,1,1,2018-02-04T15:33:19Z,2018-02-04T18:21:33Z,1,0,1,1,0,1,1,0,{'LD4': 1},1,0,{'LD4': 1},
12358,3,0.103448276,1,2018-02-05T16:25:43Z,2018-03-05T18:23:52Z,29,26,3,0.103448276,2,2,1,2,{'LD3': 1},1,1,{'LD3': 1},RPC/REST/ZMQ
12362,4,1.333333333,4,2018-02-06T03:52:13Z,2018-02-08T08:22:54Z,3,2,1,0.333333333,1,3,0,4,{},0,3,{},
12364,1,0.001234568,1,2018-02-06T14:48:43Z,2020-04-26T01:25:50Z,810,809,1,0.001234568,2,1,1,0,{'LD4': 1},1,0,{'LD4': 1},"RPC/REST/ZMQ,Wallet"
12365,3,3,3,2018-02-06T17:21:18Z,2018-02-06T21:33:12Z,1,0,1,1,0,2,2,1,"{'LD4': 1, 'LD2': 1}",1,1,"{'LD4': 1, 'LD2': 1}","Build system,Linux/Unix,Upstream"
12369,2,0.005291005,1,2018-02-06T19:51:29Z,2019-02-19T13:15:40Z,378,376,2,0.005291005,3,2,1,1,{'LD4': 1},1,1,{'LD4': 1},GUI
12372,3,1.5,3,2018-02-06T22:55:29Z,2018-02-08T07:54:12Z,2,1,1,0.5,1,2,2,1,"{'LD4': 1, 'LD2': 1}",2,0,"{'LD4': 1, 'LD2': 1}",GUI
12375,3,0.049180328,1,2018-02-07T11:13:50Z,2018-04-09T00:26:36Z,61,58,3,0.049180328,4,3,2,1,{'LD3': 2},2,1,{'LD3': 2},"Bug,Tests"
12376,2,0.002460025,1,2018-02-07T11:24:58Z,2020-04-29T13:42:08Z,813,811,2,0.002460025,1,2,2,0,"{'LD1': 1, 'LD5': 1}",2,0,"{'LD1': 1, 'LD5': 1}","Docs,P2P"
12386,7,1.4,1.75,2018-02-08T10:15:38Z,2018-02-12T22:26:05Z,5,1,4,0.8,1,5,3,4,"{'LD3': 2, 'LD4': 1}",3,2,"{'LD3': 2, 'LD4': 1}",Windows
12388,1,0.029411765,1,2018-02-08T12:47:15Z,2018-03-13T16:40:05Z,34,33,1,0.029411765,1,1,0,1,{},0,1,{},Tests
12389,1,0.003311258,1,2018-02-08T14:58:17Z,2018-12-06T21:48:01Z,302,301,1,0.003311258,2,1,1,0,{'LD4': 1},1,0,{'LD4': 1},Tests
12391,5,0.020576132,1,2018-02-08T15:33:29Z,2018-10-09T05:54:15Z,243,238,5,0.020576132,6,5,0,5,{},0,5,{},Docs
12397,6,3,3,2018-02-09T14:51:16Z,2018-02-10T21:44:07Z,2,0,2,1,0,3,3,3,"{'LD4': 2, 'LD2': 1}",2,1,"{'LD4': 1, 'LD2': 1}",Questions and Help
12398,2,0.057142857,2,2018-02-09T15:29:48Z,2018-03-16T13:38:51Z,35,34,1,0.028571429,1,1,2,0,"{'LD1': 1, 'LD3': 1}",1,0,"{'LD1': 1, 'LD3': 1}",GUI
12399,1,0.001219512,1,2018-02-09T16:11:31Z,2020-05-08T22:32:49Z,820,819,1,0.001219512,1,1,1,0,{'LD4': 1},1,0,{'LD4': 1},RPC/REST/ZMQ
12400,2,0.666666667,1,2018-02-09T16:32:56Z,2018-02-12T13:50:03Z,3,1,2,0.666666667,1,2,1,1,{'LD4': 1},1,1,{'LD4': 1},"Mempool,RPC/REST/ZMQ"
12406,8,0.010943912,2,2018-02-10T18:39:04Z,2020-02-10T20:49:31Z,731,727,4,0.005471956,2,3,4,4,"{'LD3': 2, 'LD2': 2}",3,0,"{'LD3': 1, 'LD2': 2}","Block storage,Data corruption"
12411,3,0.036144578,1,2018-02-11T14:38:23Z,2018-05-05T03:52:18Z,83,80,3,0.036144578,2,1,1,2,{'LD1': 1},1,0,{'LD1': 1},GUI
12413,2,0.5,2,2018-02-12T00:15:41Z,2018-02-15T21:11:44Z,4,3,1,0.25,2,1,1,1,{'LD6': 1},1,0,{'LD6': 1},Linux/Unix
12418,4,0.25,4,2018-02-12T23:25:28Z,2018-02-28T18:36:26Z,16,15,1,0.0625,1,1,1,3,{'LD1': 1},1,0,{'LD1': 1},RPC/REST/ZMQ
12423,13,0.015681544,4.333333333,2018-02-13T12:36:59Z,2020-05-21T18:50:37Z,829,826,3,0.003618818,4,5,4,9,{'LD3': 4},3,2,{'LD3': 3},Wallet
12429,2,0.013605442,1,2018-02-14T00:29:54Z,2018-07-10T15:05:51Z,147,145,2,0.013605442,2,2,1,1,{'LD3': 1},1,1,{'LD3': 1},RPC/REST/ZMQ
12439,1,1,1,2018-02-15T03:08:16Z,2018-02-15T05:35:34Z,1,0,1,1,0,1,1,0,{'LD1': 1},1,0,{'LD1': 1},
12440,7,0.145833333,1.166666667,2018-02-15T07:09:57Z,2018-04-03T12:20:49Z,48,42,6,0.125,4,6,2,5,{'LD1': 2},2,4,{'LD1': 2},"Data corruption,UTXO Db and Indexes"
12446,4,0.063492063,1,2018-02-16T09:42:20Z,2018-04-20T02:02:36Z,63,59,4,0.063492063,3,3,3,1,"{'LD4': 2, 'LD1': 1}",2,1,"{'LD4': 2, 'LD1': 1}",macOS
12450,2,2,2,2018-02-16T13:48:46Z,2018-02-16T14:40:35Z,1,0,1,1,0,1,1,1,{'LD5': 1},1,0,{'LD5': 1},RPC/REST/ZMQ
12453,2,0.017094017,1,2018-02-16T19:03:18Z,2018-06-13T14:44:23Z,117,115,2,0.017094017,3,1,1,1,{'LD3': 1},1,0,{'LD3': 1},Tests
12457,13,0.050387597,2.166666667,2018-02-16T20:00:15Z,2018-10-31T20:52:48Z,258,252,6,0.023255814,5,5,2,11,"{'LD4': 1, 'LD3': 1}",1,4,"{'LD4': 1, 'LD3': 1}","Brainstorming,Privacy,Wallet"
12471,1,1,1,2018-02-17T09:39:21Z,2018-02-18T02:17:47Z,1,0,1,1,0,1,0,1,{},0,1,{},
12472,1,1,1,2018-02-17T10:56:10Z,2018-02-18T02:18:36Z,1,0,1,1,0,1,0,1,{},0,1,{},
12478,1,0.022727273,1,2018-02-18T07:46:38Z,2018-04-02T22:01:04Z,44,43,1,0.022727273,2,1,1,0,{'LD3': 1},1,0,{'LD3': 1},macOS
12481,1,0.5,1,2018-02-19T10:27:06Z,2018-02-21T08:40:53Z,2,1,1,0.5,1,1,1,0,{'LD4': 1},1,0,{'LD4': 1},RPC/REST/ZMQ
12483,1,1,1,2018-02-19T15:50:50Z,2018-02-20T10:33:15Z,1,0,1,1,0,1,1,0,{'LD2': 1},1,0,{'LD2': 1},
12488,1,1,1,2018-02-20T09:56:37Z,2018-02-20T20:28:41Z,1,0,1,1,0,1,1,0,{'LD2': 1},1,0,{'LD2': 1},GUI
12497,1,0.1,1,2018-02-21T07:36:25Z,2018-03-02T09:22:06Z,10,9,1,0.1,2,1,1,0,{'LD4': 1},1,0,{'LD4': 1},macOS
12498,4,0.16,1,2018-02-21T10:13:58Z,2018-03-17T15:19:42Z,25,21,4,0.16,2,3,2,2,"{'LD1': 1, 'LD5': 1}",2,1,"{'LD1': 1, 'LD5': 1}",GUI
12500,2,0.142857143,2,2018-02-21T11:52:49Z,2018-03-06T18:04:58Z,14,13,1,0.071428571,1,2,1,1,{'LD3': 1},1,1,{'LD3': 1},"GUI,good first issue"
12504,1,1,1,2018-02-21T20:28:25Z,2018-02-21T20:30:03Z,1,0,1,1,0,1,1,0,{'LD1': 1},1,0,{'LD1': 1},
12505,4,0.06557377,1.333333333,2018-02-21T20:41:33Z,2018-04-23T18:24:55Z,61,58,3,0.049180328,4,2,2,2,"{'LD4': 1, 'LD2': 1}",1,1,"{'LD4': 1, 'LD2': 1}",Wallet
12511,11,0.076388889,1.222222222,2018-02-22T19:35:15Z,2018-07-16T10:51:21Z,144,135,9,0.0625,9,8,5,6,"{'LD3': 3, 'LD4': 1, 'LD6': 1}",4,4,"{'LD3': 2, 'LD4': 1, 'LD6': 1}",Build system
12514,1,0.035714286,1,2018-02-23T02:02:55Z,2018-03-22T20:13:19Z,28,27,1,0.035714286,2,1,1,0,{'LD5': 1},1,0,{'LD5': 1},
12515,28,9.333333333,9.333333333,2018-02-23T06:00:31Z,2018-02-25T08:33:44Z,3,0,3,1,0,6,10,18,"{'LD4': 3, 'LD6': 1, 'LD1': 4, 'LD3': 1, 'LD5': 1}",3,3,"{'LD4': 2, 'LD6': 1, 'LD1': 2, 'LD3': 1, 'LD5': 1}",
12517,2,0.001869159,1,2018-02-23T07:24:06Z,2021-01-27T14:38:04Z,1070,1068,2,0.001869159,3,2,2,0,"{'LD1': 1, 'LD3': 1}",2,0,"{'LD1': 1, 'LD3': 1}","Brainstorming,P2P"
12520,6,0.1875,1.2,2018-02-23T20:10:02Z,2018-03-27T11:09:05Z,32,27,5,0.15625,3,4,2,4,"{'LD3': 1, 'LD4': 1}",2,2,"{'LD3': 1, 'LD4': 1}",GUI
12524,2,2,2,2018-02-24T03:28:37Z,2018-02-24T12:29:02Z,1,0,1,1,0,2,1,1,{'LD1': 1},1,1,{'LD1': 1},
12529,1,0.002040816,1,2018-02-24T16:39:38Z,2019-06-29T07:57:30Z,490,489,1,0.002040816,2,1,1,0,{'LD3': 1},1,0,{'LD3': 1},Build system
12530,1,0.001579779,1,2018-02-24T17:17:56Z,2019-11-19T08:26:50Z,633,632,1,0.001579779,1,1,0,1,{},0,1,{},Build system
12531,1,1,1,2018-02-25T06:05:43Z,2018-02-25T09:57:12Z,1,0,1,1,0,1,0,1,{},0,1,{},
12533,1,0.055555556,1,2018-02-25T06:21:31Z,2018-03-14T14:20:30Z,18,17,1,0.055555556,2,1,0,1,{},0,1,{},
12535,3,0.081081081,1,2018-02-26T04:34:57Z,2018-04-03T20:57:33Z,37,34,3,0.081081081,2,3,1,2,{'LD4': 1},1,2,{'LD4': 1},macOS
12536,3,1.5,3,2018-02-26T04:56:14Z,2018-02-28T01:18:28Z,2,1,1,0.5,1,2,1,2,{'LD1': 1},1,1,{'LD1': 1},
12538,4,0.8,2,2018-02-26T11:49:18Z,2018-03-02T17:13:47Z,5,3,2,0.4,1,3,3,1,"{'LD4': 2, 'LD1': 1}",2,1,"{'LD4': 1, 'LD1': 1}",RPC/REST/ZMQ
12539,2,1,1,2018-02-26T12:08:43Z,2018-02-27T17:49:29Z,2,0,2,1,0,2,0,2,{},0,2,{},
12544,4,4,4,2018-02-26T19:34:04Z,2018-02-27T14:54:50Z,1,0,1,1,0,4,1,3,{'LD3': 1},1,3,{'LD3': 1},GUI
12547,4,4,4,2018-02-26T23:20:47Z,2018-02-27T04:16:26Z,1,0,1,1,0,2,1,3,{'LD1': 1},1,1,{'LD1': 1},Wallet
12552,1,1,1,2018-02-27T05:53:43Z,2018-02-27T05:55:14Z,1,0,1,1,0,1,1,0,{'LD2': 1},1,0,{'LD2': 1},
12554,1,0.006578947,1,2018-02-27T06:56:04Z,2018-07-28T14:56:08Z,152,151,1,0.006578947,2,1,0,1,{},0,1,{},RPC/REST/ZMQ
12566,1,0.071428571,1,2018-02-28T15:50:17Z,2018-03-14T14:22:34Z,14,13,1,0.071428571,1,1,0,1,{},0,1,{},
12571,4,0.117647059,2,2018-03-01T07:07:25Z,2018-04-03T21:07:19Z,34,32,2,0.058823529,1,4,0,4,{},0,4,{},TX fees and policy
12575,1,1,1,2018-03-01T12:00:43Z,2018-03-01T12:45:56Z,1,0,1,1,0,1,0,1,{},0,1,{},
12576,3,0.016949153,1,2018-03-01T12:54:18Z,2018-08-24T20:30:30Z,177,174,3,0.016949153,2,3,2,1,"{'LD4': 1, 'LD1': 1}",2,1,"{'LD4': 1, 'LD1': 1}",Linux/Unix
12577,1,0.007142857,1,2018-03-01T17:15:58Z,2018-07-18T23:03:19Z,140,139,1,0.007142857,2,1,1,0,{'LD6': 1},1,0,{'LD6': 1},Build system
12590,1,1,1,2018-03-03T13:36:03Z,2018-03-03T13:40:57Z,1,0,1,1,0,1,1,0,{'LD2': 1},1,0,{'LD2': 1},
12591,3,0.272727273,1.5,2018-03-03T18:22:34Z,2018-03-14T14:16:57Z,11,9,2,0.181818182,2,2,2,1,"{'LD4': 1, 'LD1': 1}",2,0,"{'LD4': 1, 'LD1': 1}",macOS
12592,1,0.090909091,1,2018-03-03T23:16:09Z,2018-03-14T14:16:24Z,11,10,1,0.090909091,2,1,0,1,{},0,1,{},Linux/Unix
12595,1,0.00127551,1,2018-03-04T15:41:23Z,2020-04-26T01:26:18Z,784,783,1,0.00127551,1,1,1,0,{'LD3': 1},1,0,{'LD3': 1},RPC/REST/ZMQ
12596,4,0.048780488,2,2018-03-04T15:45:03Z,2018-05-25T10:18:36Z,82,80,2,0.024390244,1,2,3,1,"{'LD1': 1, 'LD4': 1, 'LD5': 1}",1,1,"{'LD1': 1, 'LD4': 1, 'LD5': 1}",GUI
12602,3,0.003363229,1,2018-03-05T15:32:38Z,2020-08-12T20:22:32Z,892,889,3,0.003363229,4,1,1,2,{'LD1': 1},1,0,{'LD1': 1},Build system
12608,2,0.010471204,1,2018-03-05T23:08:53Z,2018-09-11T23:12:29Z,191,189,2,0.010471204,2,2,1,1,{'LD3': 1},1,1,{'LD3': 1},Wallet
12613,2,0.01242236,1,2018-03-06T12:48:45Z,2018-08-14T08:22:32Z,161,159,2,0.01242236,2,2,0,2,{},0,2,{},"Tests,Windows"
12623,2,0.055555556,1,2018-03-06T21:14:17Z,2018-04-11T12:45:35Z,36,34,2,0.055555556,3,2,0,2,{},0,2,{},GUI
12624,7,0.032258065,1.4,2018-03-06T21:30:29Z,2018-10-09T04:00:08Z,217,212,5,0.023041475,5,5,2,5,"{'LD4': 1, 'LD3': 1}",2,3,"{'LD4': 1, 'LD3': 1}",good first issue
12628,2,0.00877193,1,2018-03-07T02:28:52Z,2018-10-20T07:42:17Z,228,226,2,0.00877193,3,1,1,1,{'LD1': 1},1,0,{'LD1': 1},"Data corruption,macOS"
12632,5,0.006297229,1.666666667,2018-03-07T15:36:20Z,2020-05-09T12:29:39Z,794,791,3,0.003778338,4,3,3,2,{'LD4': 3},1,2,{'LD4': 1},Feature
12640,1,0.052631579,1,2018-03-07T21:54:12Z,2018-03-26T13:31:33Z,19,18,1,0.052631579,2,1,1,0,{'LD3': 1},1,0,{'LD3': 1},
12642,1,0.002427184,1,2018-03-08T00:45:23Z,2019-04-23T14:14:48Z,412,411,1,0.002427184,2,1,1,0,{'LD4': 1},1,0,{'LD4': 1},GUI
12645,1,0.001282051,1,2018-03-08T14:36:46Z,2020-04-26T01:28:01Z,780,779,1,0.001282051,2,1,1,0,{'LD4': 1},1,0,{'LD4': 1},
12646,4,0.005121639,1.333333333,2018-03-08T15:28:10Z,2020-04-27T00:46:53Z,781,778,3,0.003841229,3,2,3,1,"{'LD4': 2, 'LD6': 1}",2,0,"{'LD4': 2, 'LD6': 1}","Bug,Wallet"
12651,11,0.013871375,1.375,2018-03-09T00:33:09Z,2020-05-09T12:28:07Z,793,785,8,0.010088272,7,8,3,8,"{'LD1': 2, 'LD2': 1}",2,6,"{'LD1': 1, 'LD2': 1}","Brainstorming,UTXO Db and Indexes"
12657,4,0.003838772,1.333333333,2018-03-09T22:21:59Z,2021-01-14T06:41:53Z,1042,1039,3,0.002879079,3,3,2,2,"{'LD3': 1, 'LD4': 1}",2,1,"{'LD3': 1, 'LD4': 1}",Upstream
12663,4,0.097560976,2,2018-03-10T16:26:40Z,2018-04-20T02:00:39Z,41,39,2,0.048780488,2,3,3,1,"{'LD1': 2, 'LD5': 1}",2,1,"{'LD1': 1, 'LD5': 1}",Linux/Unix
12669,1,1,1,2018-03-11T16:24:50Z,2018-03-11T18:17:32Z,1,0,1,1,0,1,0,1,{},0,1,{},
12673,1,0.333333333,1,2018-03-12T05:44:28Z,2018-03-14T14:23:45Z,3,2,1,0.333333333,1,1,0,1,{},0,1,{},RPC/REST/ZMQ
12684,1,1,1,2018-03-14T08:14:46Z,2018-03-14T14:04:02Z,1,0,1,1,0,1,1,0,{'LD4': 1},1,0,{'LD4': 1},RPC/REST/ZMQ
12688,4,0.006956522,2,2018-03-14T17:35:41Z,2019-10-09T18:35:39Z,575,573,2,0.003478261,3,3,1,3,{'LD1': 1},1,2,{'LD1': 1},GUI
12690,1,0.00129199,1,2018-03-15T00:46:54Z,2020-04-26T01:31:56Z,774,773,1,0.00129199,1,1,0,1,{},0,1,{},"Block storage,Data corruption"
12691,3,0.008379888,1,2018-03-15T02:10:13Z,2019-03-07T16:31:43Z,358,355,3,0.008379888,3,2,2,1,"{'LD4': 1, 'LD2': 1}",2,0,"{'LD4': 1, 'LD2': 1}","Tests,good first issue"
12697,8,0.010335917,1.142857143,2018-03-15T14:51:12Z,2020-04-27T00:46:16Z,774,767,7,0.009043928,5,5,5,3,"{'LD3': 2, 'LD6': 1, 'LD1': 1, 'LD5': 1}",3,2,"{'LD3': 2, 'LD6': 1, 'LD1': 1, 'LD5': 1}",Refactoring
12703,3,0.002895753,1,2018-03-16T01:50:55Z,2021-01-14T06:31:04Z,1036,1033,3,0.002895753,2,3,0,3,{},0,3,{},RPC/REST/ZMQ
12706,2,0.001906578,1,2018-03-16T14:35:53Z,2021-01-27T14:44:55Z,1049,1047,2,0.001906578,2,2,0,2,{},0,2,{},"Brainstorming,RPC/REST/ZMQ,TX fees and policy"
12724,1,1,1,2018-03-19T11:43:17Z,2018-03-19T12:04:59Z,1,0,1,1,0,1,1,0,{'LD4': 1},1,0,{'LD4': 1},
12726,2,0.002557545,1,2018-03-19T16:04:20Z,2020-05-08T22:33:32Z,782,780,2,0.002557545,1,1,0,2,{},0,1,{},Docs
12730,5,0.006402049,1.666666667,2018-03-19T23:44:53Z,2020-05-08T10:14:21Z,781,778,3,0.003841229,3,4,2,3,"{'LD4': 1, 'LD2': 1}",2,2,"{'LD4': 1, 'LD2': 1}",Brainstorming
12732,1,1,1,2018-03-20T03:19:11Z,2018-03-21T03:01:34Z,1,0,1,1,0,1,1,0,{'LD1': 1},1,0,{'LD1': 1},Windows
12733,1,0.111111111,1,2018-03-20T08:36:23Z,2018-03-28T15:46:34Z,9,8,1,0.111111111,1,1,1,0,{'LD4': 1},1,0,{'LD4': 1},RPC/REST/ZMQ
12735,3,3,3,2018-03-20T14:28:16Z,2018-03-21T11:06:10Z,1,0,1,1,0,2,2,1,"{'LD6': 1, 'LD3': 1}",2,0,"{'LD6': 1, 'LD3': 1}",Brainstorming
12738,2,0.020833333,2,2018-03-20T18:51:58Z,2018-06-24T16:53:14Z,96,95,1,0.010416667,1,1,0,2,{},0,1,{},"RPC/REST/ZMQ,Wallet"
12748,2,2,2,2018-03-21T18:01:56Z,2018-03-22T17:14:06Z,1,0,1,1,0,1,2,0,"{'LD3': 1, 'LD5': 1}",1,0,"{'LD3': 1, 'LD5': 1}","Data corruption,Linux/Unix"
12754,9,0.008991009,1.285714286,2018-03-22T11:43:05Z,2020-12-17T07:58:01Z,1001,994,7,0.006993007,7,5,5,4,"{'LD4': 2, 'LD3': 2, 'LD5': 1}",3,2,"{'LD4': 1, 'LD3': 2, 'LD5': 1}",RPC/REST/ZMQ
12761,1,0.083333333,1,2018-03-22T20:46:18Z,2018-04-03T09:37:50Z,12,11,1,0.083333333,2,1,0,1,{},0,1,{},"Docs,RPC/REST/ZMQ"
12776,1,1,1,2018-03-25T11:25:54Z,2018-03-25T13:51:02Z,1,0,1,1,0,1,0,1,{},0,1,{},
12777,1,1,1,2018-03-25T15:18:58Z,2018-03-25T23:57:59Z,1,0,1,1,0,1,0,1,{},0,1,{},Windows
12796,2,2,2,2018-03-26T19:49:05Z,2018-03-27T15:06:24Z,1,0,1,1,0,2,1,1,{'LD3': 1},1,1,{'LD3': 1},GUI
12807,1,0.001398601,1,2018-03-28T02:04:06Z,2020-03-11T02:19:59Z,715,714,1,0.001398601,1,1,1,0,{'LD3': 1},1,0,{'LD3': 1},RPC/REST/ZMQ
12817,1,0.045454545,1,2018-03-28T12:47:02Z,2018-04-18T14:53:13Z,22,21,1,0.045454545,1,1,1,0,{'LD1': 1},1,0,{'LD1': 1},
12819,1,0.5,1,2018-03-28T17:43:05Z,2018-03-29T19:31:47Z,2,1,1,0.5,1,1,1,0,{'LD1': 1},1,0,{'LD1': 1},
12824,4,0.005181347,2,2018-03-29T00:19:48Z,2020-05-08T22:34:05Z,772,770,2,0.002590674,2,3,2,2,"{'LD4': 1, 'LD3': 1}",1,2,"{'LD4': 1, 'LD3': 1}",RPC/REST/ZMQ
12828,2,0.00486618,1,2018-03-29T12:52:58Z,2019-05-13T16:48:07Z,411,409,2,0.00486618,2,2,1,1,{'LD3': 1},1,1,{'LD3': 1},"Block storage,Docs"
12834,2,0.002635046,1,2018-03-29T23:12:19Z,2020-04-26T01:36:40Z,759,757,2,0.002635046,3,2,1,1,{'LD4': 1},1,1,{'LD4': 1},GUI
12835,1,0.1,1,2018-03-30T07:37:54Z,2018-04-08T17:48:24Z,10,9,1,0.1,1,1,1,0,{'LD6': 1},1,0,{'LD6': 1},Tests
12838,1,0.04,1,2018-03-30T09:30:24Z,2018-04-23T19:02:18Z,25,24,1,0.04,2,1,1,0,{'LD3': 1},1,0,{'LD3': 1},GUI
12841,2,2,2,2018-03-30T13:47:23Z,2018-03-30T21:30:26Z,1,0,1,1,0,2,1,1,{'LD5': 1},1,1,{'LD5': 1},
12847,1,0.5,1,2018-03-31T08:54:37Z,2018-04-01T19:35:53Z,2,1,1,0.5,1,1,1,0,{'LD2': 1},1,0,{'LD2': 1},
12848,1,1,1,2018-03-31T10:20:56Z,2018-03-31T11:27:47Z,1,0,1,1,0,1,1,0,{'LD2': 1},1,0,{'LD2': 1},
12858,2,2,2,2018-04-02T11:49:16Z,2018-04-02T15:50:10Z,1,0,1,1,0,2,0,2,{},0,2,{},RPC/REST/ZMQ
12863,5,0.012690355,1.666666667,2018-04-02T20:47:03Z,2019-05-01T14:08:01Z,394,391,3,0.007614213,2,4,0,5,{},0,4,{},"Tests,good first issue"
12864,10,0.086206897,2,2018-04-02T23:05:37Z,2018-07-27T15:56:27Z,116,111,5,0.043103448,4,5,5,5,"{'LD3': 2, 'LD4': 2, 'LD6': 1}",2,3,"{'LD3': 2, 'LD4': 2, 'LD6': 1}","Docs,RPC/REST/ZMQ"
12865,2,0.4,1,2018-04-02T23:54:43Z,2018-04-07T18:19:20Z,5,3,2,0.4,3,1,1,1,{'LD4': 1},1,0,{'LD4': 1},
12866,1,0.058823529,1,2018-04-03T03:53:31Z,2018-04-20T01:57:45Z,17,16,1,0.058823529,2,1,1,0,{'LD4': 1},1,0,{'LD4': 1},macOS
12867,1,0.0625,1,2018-04-03T04:10:52Z,2018-04-18T05:08:24Z,16,15,1,0.0625,1,1,1,0,{'LD3': 1},1,0,{'LD3': 1},"Build system,macOS"
12868,2,0.007633588,1,2018-04-03T07:28:35Z,2018-12-20T20:57:53Z,262,260,2,0.007633588,1,2,1,1,{'LD4': 1},1,1,{'LD4': 1},
12872,3,0.00397878,3,2018-04-03T19:48:34Z,2020-04-26T01:37:21Z,754,753,1,0.00132626,1,3,3,0,"{'LD1': 2, 'LD4': 1}",3,0,"{'LD1': 2, 'LD4': 1}",
12875,1,1,1,2018-04-03T22:55:35Z,2018-04-03T23:03:36Z,1,0,1,1,0,1,0,1,{},0,1,{},
12876,2,0.153846154,1,2018-04-04T04:24:05Z,2018-04-16T21:36:38Z,13,11,2,0.153846154,2,2,1,1,{'LD3': 1},1,1,{'LD3': 1},Build system
12880,1,0.2,1,2018-04-04T08:32:01Z,2018-04-09T02:50:12Z,5,4,1,0.2,2,1,1,0,{'LD4': 1},1,0,{'LD4': 1},RPC/REST/ZMQ
12903,3,0.037974684,1.5,2018-04-06T14:45:11Z,2018-06-24T13:32:43Z,79,77,2,0.025316456,3,2,1,2,{'LD5': 1},1,1,{'LD5': 1},
12913,2,0.2,1,2018-04-08T10:40:31Z,2018-04-17T18:00:27Z,10,8,2,0.2,2,2,0,2,{},0,2,{},"Build system,Questions and Help"
12943,2,1,1,2018-04-11T12:32:28Z,2018-04-13T09:51:47Z,2,0,2,1,0,2,2,0,"{'LD1': 1, 'LD5': 1}",2,0,"{'LD1': 1, 'LD5': 1}",
12945,1,1,1,2018-04-11T14:11:53Z,2018-04-12T13:13:04Z,1,0,1,1,0,1,0,1,{},0,1,{},"Tests,Up for grabs"
12948,2,0.008163265,1,2018-04-11T17:31:01Z,2018-12-12T16:29:27Z,245,243,2,0.008163265,3,2,0,2,{},0,2,{},RPC/REST/ZMQ
12952,5,0.035460993,1.666666667,2018-04-11T19:00:28Z,2018-08-30T18:53:46Z,141,138,3,0.021276596,3,4,4,1,"{'LD2': 1, 'LD6': 1, 'LD4': 2}",4,0,"{'LD2': 1, 'LD6': 1, 'LD4': 2}",Wallet
12958,1,0.5,1,2018-04-12T00:41:54Z,2018-04-13T01:12:58Z,2,1,1,0.5,1,1,0,1,{},0,1,{},
12961,5,0.151515152,2.5,2018-04-12T02:25:24Z,2018-05-14T15:53:01Z,33,31,2,0.060606061,1,3,4,1,"{'LD4': 2, 'LD2': 1, 'LD5': 1}",2,1,"{'LD4': 2, 'LD2': 1, 'LD5': 1}",
12962,1,1,1,2018-04-12T03:31:10Z,2018-04-12T14:22:54Z,1,0,1,1,0,1,1,0,{'LD2': 1},1,0,{'LD2': 1},
12964,1,1,1,2018-04-12T07:27:56Z,2018-04-12T09:07:45Z,1,0,1,1,0,1,0,1,{},0,1,{},
12974,1,0.142857143,1,2018-04-13T06:53:35Z,2018-04-20T01:56:57Z,7,6,1,0.142857143,1,1,1,0,{'LD4': 1},1,0,{'LD4': 1},macOS
12978,13,3.25,3.25,2018-04-13T15:47:11Z,2018-04-17T14:02:08Z,4,0,4,1,0,6,3,10,"{'LD3': 2, 'LD4': 1}",3,3,"{'LD3': 2, 'LD4': 1}",Tests
12989,11,0.025641026,2.2,2018-04-15T15:52:08Z,2019-06-18T12:53:54Z,429,424,5,0.011655012,5,7,3,8,"{'LD4': 2, 'LD1': 1}",2,5,"{'LD4': 1, 'LD1': 1}",RPC/REST/ZMQ
12994,4,0.006309148,1,2018-04-16T14:29:41Z,2020-01-09T20:05:53Z,634,630,4,0.006309148,4,4,0,4,{},0,4,{},"Utils/log/libs,Validation"
12995,6,0.75,2,2018-04-16T14:31:35Z,2018-04-24T12:08:28Z,8,5,3,0.375,4,4,5,1,"{'LD6': 1, 'LD3': 2, 'LD4': 1, 'LD1': 1}",3,1,"{'LD6': 1, 'LD3': 2, 'LD4': 1, 'LD1': 1}","Scripts and tools,Tests"
13001,1,1,1,2018-04-16T17:10:46Z,2018-04-16T20:20:59Z,1,0,1,1,0,1,1,0,{'LD4': 1},1,0,{'LD4': 1},
13006,8,0.061538462,2.666666667,2018-04-17T11:32:27Z,2018-08-24T18:09:40Z,130,127,3,0.023076923,2,5,5,3,"{'LD1': 1, 'LD3': 4}",4,1,"{'LD1': 1, 'LD3': 3}","Tests,good first issue"
13009,2,0.666666667,2,2018-04-17T19:40:12Z,2018-04-20T01:52:31Z,3,2,1,0.333333333,1,2,1,1,{'LD2': 1},1,1,{'LD2': 1},Data corruption
13035,1,1,1,2018-04-20T02:40:20Z,2018-04-20T15:26:19Z,1,0,1,1,0,1,0,1,{},0,1,{},
13059,10,0.012738854,1.25,2018-04-23T17:37:02Z,2020-06-16T14:44:53Z,785,777,8,0.010191083,8,5,2,8,{'LD5': 2},2,3,{'LD5': 2},"Feature,Wallet"
13078,3,0.055555556,1.5,2018-04-25T20:35:34Z,2018-06-18T20:20:34Z,54,52,2,0.037037037,1,1,1,2,{'LD4': 1},1,0,{'LD4': 1},Resource usage
13085,3,3,3,2018-04-26T00:27:06Z,2018-04-26T02:11:49Z,1,0,1,1,0,3,1,2,{'LD2': 1},1,2,{'LD2': 1},
13086,5,0.006830601,1,2018-04-26T04:57:56Z,2020-04-27T00:44:39Z,732,727,5,0.006830601,4,4,1,4,{'LD4': 1},1,3,{'LD4': 1},Tests
13087,3,0.014925373,1.5,2018-04-26T09:58:31Z,2018-11-13T07:52:50Z,201,199,2,0.009950249,3,2,3,0,"{'LD4': 1, 'LD3': 2}",2,0,"{'LD4': 1, 'LD3': 2}",RPC/REST/ZMQ
13089,1,1,1,2018-04-26T13:08:28Z,2018-04-26T13:30:10Z,1,0,1,1,0,1,1,0,{'LD4': 1},1,0,{'LD4': 1},Linux/Unix
13092,1,0.043478261,1,2018-04-26T15:59:17Z,2018-05-18T18:23:46Z,23,22,1,0.043478261,1,1,0,1,{},0,1,{},Validation
13103,6,0.020477816,2,2018-04-27T14:05:06Z,2019-02-13T17:21:29Z,293,290,3,0.010238908,2,4,3,3,"{'LD4': 2, 'LD5': 1}",3,1,"{'LD4': 2, 'LD5': 1}","GUI,Windows,good first issue"
13104,1,1,1,2018-04-27T15:44:13Z,2018-04-27T16:01:23Z,1,0,1,1,0,1,0,1,{},0,1,{},
13108,2,0.002743484,1,2018-04-28T05:49:53Z,2020-04-26T01:43:55Z,729,727,2,0.002743484,2,2,2,0,"{'LD3': 1, 'LD2': 1}",2,0,"{'LD3': 1, 'LD2': 1}",RPC/REST/ZMQ
13110,4,0.2,1.333333333,2018-04-28T19:01:50Z,2018-05-18T10:55:43Z,20,17,3,0.15,2,2,1,3,{'LD1': 1},1,1,{'LD1': 1},"Bug,Wallet"
13117,2,0.011494253,1,2018-04-29T21:53:38Z,2018-10-20T07:46:15Z,174,172,2,0.011494253,3,2,2,0,"{'LD4': 1, 'LD3': 1}",2,0,"{'LD4': 1, 'LD3': 1}",macOS
13121,1,1,1,2018-04-30T02:04:30Z,2018-04-30T12:13:11Z,1,0,1,1,0,1,1,0,{'LD3': 1},1,0,{'LD3': 1},Windows
13140,2,0.00270636,2,2018-05-01T20:04:39Z,2020-05-08T22:34:28Z,739,738,1,0.00135318,1,1,1,1,{'LD1': 1},1,0,{'LD1': 1},Brainstorming
13143,5,0.025641026,5,2018-05-01T22:04:27Z,2018-11-12T14:24:44Z,195,194,1,0.005128205,1,3,2,3,{'LD2': 2},1,2,{'LD2': 1},RPC/REST/ZMQ
13147,2,2,2,2018-05-02T03:26:49Z,2018-05-02T15:44:52Z,1,0,1,1,0,2,2,0,"{'LD1': 1, 'LD4': 1}",2,0,"{'LD1': 1, 'LD4': 1}",GUI
13169,2,0.003115265,1,2018-05-04T21:04:13Z,2020-02-05T03:15:31Z,642,640,2,0.003115265,3,2,1,1,{'LD4': 1},1,1,{'LD4': 1},"GUI,Linux/Unix"
13182,4,0.666666667,1.333333333,2018-05-07T01:27:44Z,2018-05-12T19:03:40Z,6,3,3,0.5,2,3,1,3,{'LD1': 1},1,2,{'LD1': 1},Linux/Unix
13187,1,1,1,2018-05-07T22:32:55Z,2018-05-07T22:40:06Z,1,0,1,1,0,1,1,0,{'LD1': 1},1,0,{'LD1': 1},
13207,2,0.037735849,2,2018-05-10T09:43:19Z,2018-07-01T12:17:19Z,53,52,1,0.018867925,1,2,1,1,{'LD4': 1},1,1,{'LD4': 1},
13217,7,0.008474576,1.75,2018-05-11T16:31:59Z,2020-08-14T06:49:54Z,826,822,4,0.004842615,4,4,5,2,"{'LD4': 1, 'LD3': 1, 'LD6': 1, 'LD2': 2}",4,0,"{'LD4': 1, 'LD3': 1, 'LD6': 1, 'LD2': 1}","GUI,RPC/REST/ZMQ"
13224,1,1,1,2018-05-13T03:44:27Z,2018-05-13T07:43:13Z,1,0,1,1,0,1,0,1,{},0,1,{},Linux/Unix
13225,4,4,4,2018-05-13T07:51:12Z,2018-05-13T11:42:21Z,1,0,1,1,0,1,4,0,"{'LD1': 3, 'LD4': 1}",1,0,"{'LD1': 1, 'LD4': 1}",Linux/Unix
13231,2,0.181818182,1,2018-05-14T09:52:19Z,2018-05-24T13:53:32Z,11,9,2,0.181818182,2,2,1,1,{'LD6': 1},1,1,{'LD6': 1},"GUI,good first issue"
13237,7,0.01088647,2.333333333,2018-05-15T14:31:55Z,2020-02-17T11:00:19Z,643,640,3,0.00466563,3,3,2,5,"{'LD3': 1, 'LD4': 1}",2,1,"{'LD3': 1, 'LD4': 1}",Wallet
13244,1,0.333333333,1,2018-05-16T09:15:40Z,2018-05-18T17:55:29Z,3,2,1,0.333333333,1,1,0,1,{},0,1,{},
13245,5,0.006906077,1.25,2018-05-16T12:19:43Z,2020-05-09T11:50:09Z,724,720,4,0.005524862,4,3,4,1,"{'LD4': 1, 'LD6': 1, 'LD3': 1, 'LD5': 1}",3,0,"{'LD4': 1, 'LD6': 1, 'LD3': 1, 'LD5': 1}","Docs,GUI,Wallet"
13256,5,1.666666667,5,2018-05-17T04:32:11Z,2018-05-20T00:31:12Z,3,2,1,0.333333333,1,5,1,4,{'LD4': 1},1,4,{'LD4': 1},TX fees and policy
13260,1,0.00591716,1,2018-05-17T07:50:53Z,2018-11-02T07:50:42Z,169,168,1,0.00591716,1,1,0,1,{},0,1,{},Windows
13261,3,3,3,2018-05-17T09:00:13Z,2018-05-17T13:05:43Z,1,0,1,1,0,3,0,3,{},0,3,{},
13263,7,0.583333333,1.75,2018-05-17T12:07:24Z,2018-05-28T14:29:30Z,12,8,4,0.333333333,2,4,5,2,"{'LD3': 3, 'LD4': 1, 'LD2': 1}",4,0,"{'LD3': 2, 'LD4': 1, 'LD2': 1}",Tests
13270,1,1,1,2018-05-18T03:18:31Z,2018-05-18T05:41:19Z,1,0,1,1,0,1,1,0,{'LD3': 1},1,0,{'LD3': 1},
13277,1,1,1,2018-05-18T14:18:01Z,2018-05-18T17:51:46Z,1,0,1,1,0,1,1,0,{'LD4': 1},1,0,{'LD4': 1},
13285,10,2,2.5,2018-05-20T11:11:48Z,2018-05-24T17:06:27Z,5,1,4,0.8,1,3,5,5,"{'LD6': 3, 'LD3': 2}",2,1,"{'LD6': 2, 'LD3': 1}",Tests
13287,2,0.133333333,2,2018-05-20T12:50:26Z,2018-06-04T03:52:34Z,15,14,1,0.066666667,1,1,2,0,"{'LD3': 1, 'LD1': 1}",1,0,"{'LD3': 1, 'LD1': 1}",GUI
13290,5,1.666666667,5,2018-05-21T05:49:30Z,2018-05-23T07:44:53Z,3,2,1,0.333333333,1,4,2,3,"{'LD5': 1, 'LD3': 1}",2,2,"{'LD5': 1, 'LD3': 1}",
13296,1,0.001602564,1,2018-05-21T15:26:38Z,2020-02-04T10:11:12Z,624,623,1,0.001602564,2,1,1,0,{'LD4': 1},1,0,{'LD4': 1},GUI
13299,1,0.0041841,1,2018-05-21T23:17:15Z,2019-01-15T16:40:06Z,239,238,1,0.0041841,1,1,0,1,{},0,1,{},"Bug,GUI"
13302,3,1.5,3,2018-05-22T07:55:49Z,2018-05-23T14:08:31Z,2,1,1,0.5,1,2,1,2,{'LD1': 1},1,1,{'LD1': 1},
13303,1,0.00877193,1,2018-05-22T19:27:26Z,2018-09-13T12:08:10Z,114,113,1,0.00877193,1,1,1,0,{'LD3': 1},1,0,{'LD3': 1},"GUI,Up for grabs"
13313,3,0.004255319,1,2018-05-23T18:35:31Z,2020-04-26T22:29:33Z,705,702,3,0.004255319,3,2,2,1,"{'LD1': 1, 'LD3': 1}",2,0,"{'LD1': 1, 'LD3': 1}",RPC/REST/ZMQ
13316,2,2,2,2018-05-24T17:07:43Z,2018-05-25T09:23:47Z,1,0,1,1,0,2,1,1,{'LD1': 1},1,1,{'LD1': 1},Questions and Help
13337,5,1.25,2.5,2018-05-28T13:18:27Z,2018-06-01T08:10:14Z,4,2,2,0.5,2,3,3,2,"{'LD1': 1, 'LD3': 1, 'LD2': 1}",2,1,"{'LD1': 1, 'LD3': 1, 'LD2': 1}",Linux/Unix
13343,1,0.035714286,1,2018-05-29T19:49:27Z,2018-06-25T23:16:13Z,28,27,1,0.035714286,2,1,1,0,{'LD1': 1},1,0,{'LD1': 1},"Linux/Unix,P2P"
13344,8,0.011477762,1.333333333,2018-05-30T10:35:37Z,2020-04-26T01:49:49Z,697,691,6,0.008608321,3,5,5,3,"{'LD4': 4, 'LD3': 1}",3,2,"{'LD4': 3, 'LD3': 1}",Linux/Unix
13354,1,0.5,1,2018-05-31T04:11:19Z,2018-06-01T14:41:24Z,2,1,1,0.5,1,1,0,1,{},0,1,{},"Questions and Help,TX fees and policy"
13356,19,0.038696538,2.375,2018-05-31T08:47:20Z,2019-10-03T14:44:45Z,491,483,8,0.016293279,6,7,6,13,"{'LD4': 3, 'LD1': 1, 'LD2': 1, 'LD3': 1}",5,2,"{'LD4': 2, 'LD1': 1, 'LD2': 1, 'LD3': 1}","Brainstorming,Build system"
13358,3,0.004304161,1.5,2018-05-31T14:17:00Z,2020-04-27T00:50:17Z,697,695,2,0.00286944,2,2,2,1,"{'LD4': 1, 'LD3': 1}",2,0,"{'LD4': 1, 'LD3': 1}",Windows
13361,1,1,1,2018-06-01T02:46:00Z,2018-06-01T02:54:37Z,1,0,1,1,0,1,1,0,{'LD2': 1},1,0,{'LD2': 1},
13362,7,0.127272727,1,2018-06-01T03:11:31Z,2018-07-25T10:54:50Z,55,48,7,0.127272727,7,6,7,0,{'LD3': 7},6,0,{'LD3': 6},"Brainstorming,macOS"
13363,1,0.125,1,2018-06-01T09:38:57Z,2018-06-08T14:55:04Z,8,7,1,0.125,1,1,1,0,{'LD6': 1},1,0,{'LD6': 1},"Utils/log/libs,good first issue"
13376,3,0.004901961,1,2018-06-03T11:18:47Z,2020-02-04T12:16:20Z,612,609,3,0.004901961,3,2,2,1,"{'LD6': 1, 'LD4': 1}",2,0,"{'LD6': 1, 'LD4': 1}",GUI
13377,2,0.002886003,1,2018-06-03T11:22:19Z,2020-04-26T01:50:38Z,693,691,2,0.002886003,2,1,1,1,{'LD4': 1},1,0,{'LD4': 1},Windows
13387,2,2,2,2018-06-04T00:41:59Z,2018-06-04T01:18:02Z,1,0,1,1,0,2,0,2,{},0,2,{},
13397,2,0.003062787,1,2018-06-05T14:10:48Z,2020-03-19T13:00:15Z,653,651,2,0.003062787,2,2,0,2,{},0,2,{},P2P
13398,1,0.02173913,1,2018-06-05T16:22:39Z,2018-07-21T07:07:17Z,46,45,1,0.02173913,2,1,0,1,{},0,1,{},macOS
13403,6,6,6,2018-06-05T21:11:04Z,2018-06-06T19:27:20Z,1,0,1,1,0,5,0,6,{},0,5,{},Brainstorming
13405,9,9,9,2018-06-06T06:12:07Z,2018-06-06T22:37:26Z,1,0,1,1,0,5,6,3,"{'LD4': 2, 'LD3': 4}",4,1,"{'LD4': 2, 'LD3': 3}",Questions and Help
13411,3,0.004273504,1,2018-06-07T14:13:20Z,2020-05-08T23:38:43Z,702,699,3,0.004273504,3,3,1,2,{'LD3': 1},1,2,{'LD3': 1},Brainstorming
13427,14,0.020028612,2.8,2018-06-10T18:44:47Z,2020-05-08T22:35:28Z,699,694,5,0.007153076,4,4,8,6,"{'LD4': 1, 'LD1': 5, 'LD3': 2}",3,1,"{'LD4': 1, 'LD1': 1, 'LD3': 2}",RPC/REST/ZMQ
13432,5,1.666666667,5,2018-06-11T08:17:43Z,2018-06-13T13:50:11Z,3,2,1,0.333333333,1,3,2,3,"{'LD1': 1, 'LD3': 1}",1,2,"{'LD1': 1, 'LD3': 1}",Build system
13436,5,1.25,1.666666667,2018-06-11T09:58:24Z,2018-06-15T02:52:36Z,4,1,3,0.75,1,3,1,4,{'LD3': 1},1,2,{'LD3': 1},P2P
13459,4,0.011527378,1,2018-06-13T16:03:50Z,2019-05-25T22:10:05Z,347,343,4,0.011527378,5,3,1,3,{'LD3': 1},1,2,{'LD3': 1},"Build system,macOS"
13478,25,0.102040816,1.666666667,2018-06-15T15:36:32Z,2019-02-14T20:18:47Z,245,230,15,0.06122449,13,8,4,21,"{'LD4': 3, 'LD3': 1}",4,4,"{'LD4': 3, 'LD3': 1}","Build system,GUI"
13487,2,0.4,1,2018-06-17T07:21:17Z,2018-06-22T06:37:39Z,5,3,2,0.4,1,2,1,1,{'LD5': 1},1,1,{'LD5': 1},
13495,4,0.081632653,1,2018-06-18T13:34:27Z,2018-08-05T17:25:12Z,49,45,4,0.081632653,4,3,0,4,{},0,3,{},GUI
13502,3,3,3,2018-06-19T13:27:07Z,2018-06-19T15:33:26Z,1,0,1,1,0,3,2,1,"{'LD4': 1, 'LD5': 1}",2,1,"{'LD4': 1, 'LD5': 1}",Questions and Help
13504,1,1,1,2018-06-19T13:54:00Z,2018-06-19T14:39:27Z,1,0,1,1,0,1,1,0,{'LD4': 1},1,0,{'LD4': 1},
13505,3,0.6,1.5,2018-06-19T15:02:58Z,2018-06-24T03:06:45Z,5,3,2,0.4,2,3,2,1,{'LD1': 2},2,1,{'LD1': 2},
13509,3,0.004354136,1.5,2018-06-20T11:11:12Z,2020-05-08T22:36:19Z,689,687,2,0.002902758,3,3,2,1,"{'LD4': 1, 'LD1': 1}",2,1,"{'LD4': 1, 'LD1': 1}",Wallet
13511,3,0.75,1.5,2018-06-20T19:47:13Z,2018-06-24T16:54:15Z,4,2,2,0.5,2,2,1,2,{'LD4': 1},1,1,{'LD4': 1},RPC/REST/ZMQ
13516,1,1,1,2018-06-21T13:19:20Z,2018-06-21T14:27:32Z,1,0,1,1,0,1,0,1,{},0,1,{},GUI
13518,1,0.00591716,1,2018-06-21T13:58:25Z,2018-12-06T21:48:28Z,169,168,1,0.00591716,1,1,1,0,{'LD3': 1},1,0,{'LD3': 1},Tests
13519,3,0.009966777,1.5,2018-06-21T14:00:42Z,2019-04-17T21:00:26Z,301,299,2,0.006644518,2,2,2,1,{'LD4': 2},2,0,{'LD4': 2},"Brainstorming,Tests"
13520,1,0.1,1,2018-06-22T06:08:30Z,2018-07-01T11:34:53Z,10,9,1,0.1,2,1,0,1,{},0,1,{},
13523,1,0.005952381,1,2018-06-22T16:43:34Z,2018-12-06T21:49:59Z,168,167,1,0.005952381,2,1,0,1,{},0,1,{},Tests
13526,4,0.235294118,4,2018-06-23T16:56:14Z,2018-07-10T08:53:05Z,17,16,1,0.058823529,2,3,1,3,{'LD1': 1},1,2,{'LD1': 1},RPC/REST/ZMQ
13538,1,0.071428571,1,2018-06-25T22:50:22Z,2018-07-09T13:56:42Z,14,13,1,0.071428571,1,1,1,0,{'LD3': 1},1,0,{'LD3': 1},"Build system,Linux/Unix"
13552,2,0.090909091,2,2018-06-27T20:49:18Z,2018-07-19T11:07:11Z,22,21,1,0.045454545,1,2,1,1,{'LD5': 1},1,1,{'LD5': 1},Wallet
13553,4,0.06557377,1.333333333,2018-06-27T21:26:05Z,2018-08-27T11:37:04Z,61,58,3,0.049180328,3,2,1,3,{'LD3': 1},1,1,{'LD3': 1},"Tests,good first issue"
13556,1,1,1,2018-06-28T00:36:46Z,2018-06-28T10:44:48Z,1,0,1,1,0,1,0,1,{},0,1,{},Questions and Help
13559,3,0.136363636,1.5,2018-06-28T06:28:34Z,2018-07-19T08:58:07Z,22,20,2,0.090909091,2,2,1,2,{'LD4': 1},1,1,{'LD4': 1},
13567,1,0.020408163,1,2018-06-28T19:30:22Z,2018-08-16T18:38:15Z,49,48,1,0.020408163,1,1,1,0,{'LD1': 1},1,0,{'LD1': 1},Build system
13576,2,0.333333333,1,2018-06-30T09:50:46Z,2018-07-05T11:35:39Z,6,4,2,0.333333333,1,2,1,1,{'LD5': 1},1,1,{'LD5': 1},"Build system,Linux/Unix"
13581,15,0.033783784,3,2018-07-01T16:37:17Z,2019-09-18T14:33:36Z,444,439,5,0.011261261,4,4,8,7,"{'LD1': 4, 'LD5': 1, 'LD6': 1, 'LD3': 2}",4,0,"{'LD1': 3, 'LD5': 1, 'LD6': 1, 'LD3': 2}",Build system
13585,10,0.769230769,2,2018-07-02T00:56:45Z,2018-07-14T02:36:23Z,13,8,5,0.384615385,3,3,4,6,"{'LD2': 1, 'LD4': 1, 'LD3': 1, 'LD1': 1}",2,1,"{'LD2': 1, 'LD4': 1, 'LD3': 1, 'LD1': 1}",
13590,1,0.5,1,2018-07-03T15:05:24Z,2018-07-05T07:16:05Z,2,1,1,0.5,1,1,1,0,{'LD4': 1},1,0,{'LD4': 1},Questions and Help
13591,2,0.285714286,2,2018-07-03T18:02:25Z,2018-07-10T11:53:07Z,7,6,1,0.142857143,1,2,2,0,{'LD1': 2},2,0,{'LD1': 2},Questions and Help
13594,7,0.01208981,1.166666667,2018-07-04T08:07:14Z,2020-02-03T01:16:49Z,579,573,6,0.010362694,5,5,0,7,{},0,5,{},macOS
13595,2,0.117647059,1,2018-07-04T11:35:06Z,2018-07-21T07:03:32Z,17,15,2,0.117647059,1,2,1,1,{'LD4': 1},1,1,{'LD4': 1},macOS
13597,2,0.133333333,1,2018-07-05T02:13:44Z,2018-07-19T08:08:57Z,15,13,2,0.133333333,2,1,2,0,"{'LD3': 1, 'LD1': 1}",1,0,"{'LD3': 1, 'LD1': 1}",
13599,1,0.2,1,2018-07-05T14:36:19Z,2018-07-09T18:09:15Z,5,4,1,0.2,1,1,1,0,{'LD3': 1},1,0,{'LD3': 1},
13601,3,0.025,1,2018-07-05T21:03:54Z,2018-11-02T07:33:09Z,120,117,3,0.025,4,3,1,2,{'LD3': 1},1,2,{'LD3': 1},macOS
13606,7,0.012110727,1.75,2018-07-06T20:44:08Z,2020-02-04T10:10:34Z,578,574,4,0.006920415,5,3,3,4,"{'LD4': 2, 'LD2': 1}",2,1,"{'LD4': 2, 'LD2': 1}","GUI,Linux/Unix"
13620,1,0.125,1,2018-07-10T02:26:40Z,2018-07-17T18:04:31Z,8,7,1,0.125,1,1,0,1,{},0,1,{},"Scripts and tools,good first issue"
13629,1,1,1,2018-07-11T02:42:19Z,2018-07-11T13:36:40Z,1,0,1,1,0,1,1,0,{'LD4': 1},1,0,{'LD4': 1},
13635,1,1,1,2018-07-11T14:02:53Z,2018-07-11T14:49:55Z,1,0,1,1,0,1,1,0,{'LD4': 1},1,0,{'LD4': 1},Questions and Help
13640,3,3,3,2018-07-12T07:19:05Z,2018-07-12T15:46:28Z,1,0,1,1,0,2,2,1,"{'LD1': 1, 'LD2': 1}",2,0,"{'LD1': 1, 'LD2': 1}",
13641,1,1,1,2018-07-12T07:28:38Z,2018-07-12T07:51:35Z,1,0,1,1,0,1,0,1,{},0,1,{},Questions and Help
13642,2,2,2,2018-07-12T10:02:20Z,2018-07-12T15:46:47Z,1,0,1,1,0,2,2,0,"{'LD1': 1, 'LD2': 1}",2,0,"{'LD1': 1, 'LD2': 1}",
13653,1,1,1,2018-07-13T05:13:51Z,2018-07-13T05:20:14Z,1,0,1,1,0,1,0,1,{},0,1,{},Build system
13661,1,0.25,1,2018-07-14T03:36:24Z,2018-07-17T19:00:14Z,4,3,1,0.25,1,1,1,0,{'LD1': 1},1,0,{'LD1': 1},"RPC/REST/ZMQ,Tests"
13685,2,2,2,2018-07-17T10:05:50Z,2018-07-17T10:20:27Z,1,0,1,1,0,2,2,0,"{'LD5': 1, 'LD2': 1}",2,0,"{'LD5': 1, 'LD2': 1}",
13688,5,0.008802817,2.5,2018-07-17T12:16:38Z,2020-02-05T11:29:03Z,568,566,2,0.003521127,2,3,3,2,"{'LD1': 2, 'LD3': 1}",3,0,"{'LD1': 2, 'LD3': 1}",Build system
13694,5,2.5,2.5,2018-07-17T20:36:52Z,2018-07-19T11:17:27Z,2,0,2,1,0,4,2,3,"{'LD2': 1, 'LD4': 1}",2,2,"{'LD2': 1, 'LD4': 1}","Build system,Questions and Help"
13700,5,0.384615385,2.5,2018-07-18T08:02:15Z,2018-07-30T17:08:54Z,13,11,2,0.153846154,1,4,1,4,{'LD1': 1},1,3,{'LD1': 1},Build system
13701,2,0.014814815,1,2018-07-18T08:10:06Z,2018-11-29T12:27:22Z,135,133,2,0.014814815,2,1,1,1,{'LD1': 1},1,0,{'LD1': 1},
13704,3,0.428571429,1.5,2018-07-18T18:36:05Z,2018-07-25T11:03:35Z,7,5,2,0.285714286,1,3,0,3,{},0,3,{},"RPC/REST/ZMQ,Wallet"
13730,2,2,2,2018-07-21T05:14:43Z,2018-07-21T12:09:18Z,1,0,1,1,0,2,2,0,{'LD4': 2},2,0,{'LD4': 2},Windows
13735,2,2,2,2018-07-21T22:48:05Z,2018-07-22T08:50:47Z,1,0,1,1,0,1,0,2,{},0,1,{},Build system
13736,11,0.01674277,1.833333333,2018-07-22T00:02:53Z,2020-05-08T22:35:51Z,657,651,6,0.00913242,5,7,1,10,{'LD5': 1},1,6,{'LD5': 1},
13738,1,0.003021148,1,2018-07-22T13:44:10Z,2019-06-18T12:53:55Z,331,330,1,0.003021148,2,1,0,1,{},0,1,{},Tests
13745,2,2,2,2018-07-23T09:10:55Z,2018-07-23T14:06:34Z,1,0,1,1,0,2,1,1,{'LD1': 1},1,1,{'LD1': 1},Tests
13748,1,1,1,2018-07-23T18:24:28Z,2018-07-24T18:16:56Z,1,0,1,1,0,1,0,1,{},0,1,{},"Tests,good first issue"
13749,2,0.25,2,2018-07-24T10:22:19Z,2018-07-31T17:02:17Z,8,7,1,0.125,2,1,0,2,{},0,1,{},Linux/Unix
13752,1,0.1,1,2018-07-24T14:15:35Z,2018-08-02T15:47:56Z,10,9,1,0.1,1,1,0,1,{},0,1,{},macOS
13754,6,0.375,1.5,2018-07-24T15:55:03Z,2018-08-09T12:06:11Z,16,12,4,0.25,3,3,3,3,"{'LD2': 2, 'LD3': 1}",3,0,"{'LD2': 2, 'LD3': 1}","Wallet,Windows"
13757,1,1,1,2018-07-25T12:01:58Z,2018-07-25T12:14:53Z,1,0,1,1,0,1,1,0,{'LD1': 1},1,0,{'LD1': 1},Questions and Help
13759,1,0.003623188,1,2018-07-25T16:18:11Z,2019-04-26T16:46:38Z,276,275,1,0.003623188,2,1,1,0,{'LD4': 1},1,0,{'LD4': 1},Build system
13772,2,0.003584229,1,2018-07-26T20:40:51Z,2020-02-04T10:10:57Z,558,556,2,0.003584229,3,2,1,1,{'LD4': 1},1,1,{'LD4': 1},GUI
13777,1,0.2,1,2018-07-27T08:21:54Z,2018-07-31T23:17:51Z,5,4,1,0.2,2,1,0,1,{},0,1,{},Docs
13800,1,1,1,2018-07-30T08:04:40Z,2018-07-30T08:21:42Z,1,0,1,1,0,1,1,0,{'LD4': 1},1,0,{'LD4': 1},
13813,4,4,4,2018-07-30T19:46:12Z,2018-07-31T19:28:06Z,1,0,1,1,0,3,3,1,"{'LD4': 1, 'LD3': 1, 'LD6': 1}",2,1,"{'LD4': 1, 'LD3': 1, 'LD6': 1}","Tests,good first issue"
13826,2,0.142857143,1,2018-07-31T22:19:41Z,2018-08-14T14:29:09Z,14,12,2,0.142857143,1,2,1,1,{'LD4': 1},1,1,{'LD4': 1},Build system
13828,4,0.009029345,2,2018-08-01T14:07:29Z,2019-10-18T07:15:40Z,443,441,2,0.004514673,2,4,1,3,{'LD3': 1},1,3,{'LD3': 1},GUI
13829,7,0.067961165,1.75,2018-08-01T14:22:54Z,2018-11-12T13:53:42Z,103,99,4,0.038834951,4,4,2,5,"{'LD4': 1, 'LD3': 1}",1,3,"{'LD4': 1, 'LD3': 1}","GUI,good first issue,macOS"
13831,1,1,1,2018-08-01T14:46:36Z,2018-08-01T14:58:58Z,1,0,1,1,0,1,1,0,{'LD2': 1},1,0,{'LD2': 1},
13832,3,3,3,2018-08-01T14:50:03Z,2018-08-02T07:14:49Z,1,0,1,1,0,3,1,2,{'LD3': 1},1,2,{'LD3': 1},macOS
13833,4,0.01980198,2,2018-08-01T15:03:34Z,2019-02-19T14:08:54Z,202,200,2,0.00990099,2,4,1,3,{'LD1': 1},1,3,{'LD1': 1},GUI
13839,2,0.003154574,1,2018-08-01T20:36:32Z,2020-04-26T01:51:50Z,634,632,2,0.003154574,2,1,0,2,{},0,1,{},
13850,2,0.010869565,1,2018-08-02T11:47:11Z,2019-02-02T11:23:27Z,184,182,2,0.010869565,1,1,0,2,{},0,1,{},RPC/REST/ZMQ
13858,1,1,1,2018-08-02T19:03:10Z,2018-08-02T19:57:32Z,1,0,1,1,0,1,0,1,{},0,1,{},Questions and Help
13865,7,0.011058452,1.4,2018-08-03T15:21:31Z,2020-04-27T00:48:35Z,633,628,5,0.007898894,5,5,4,3,"{'LD6': 2, 'LD4': 1, 'LD3': 1}",3,2,"{'LD6': 2, 'LD4': 1, 'LD3': 1}",Tests
13869,1,0.005524862,1,2018-08-03T19:09:12Z,2019-01-31T03:53:44Z,181,180,1,0.005524862,2,1,0,1,{},0,1,{},Windows
13870,1,1,1,2018-08-03T22:28:41Z,2018-08-03T22:31:32Z,1,0,1,1,0,1,1,0,{'LD2': 1},1,0,{'LD2': 1},Questions and Help
13873,3,0.04,1,2018-08-04T12:53:01Z,2018-10-18T10:27:23Z,75,72,3,0.04,3,2,1,2,{'LD2': 1},1,1,{'LD2': 1},"GUI,good first issue"
13881,1,1,1,2018-08-05T09:42:03Z,2018-08-05T09:50:31Z,1,0,1,1,0,1,0,1,{},0,1,{},
13885,2,0.02247191,1,2018-08-05T22:25:59Z,2018-11-02T07:55:51Z,89,87,2,0.02247191,2,1,2,0,"{'LD4': 1, 'LD1': 1}",1,0,"{'LD4': 1, 'LD1': 1}",Windows
13900,1,0.034482759,1,2018-08-07T09:12:42Z,2018-09-04T19:08:39Z,29,28,1,0.034482759,2,1,1,0,{'LD3': 1},1,0,{'LD3': 1},
13901,2,0.25,1,2018-08-07T12:25:20Z,2018-08-14T13:13:46Z,8,6,2,0.25,1,2,2,0,"{'LD1': 1, 'LD2': 1}",2,0,"{'LD1': 1, 'LD2': 1}",Build system
13906,1,1,1,2018-08-07T20:06:31Z,2018-08-07T21:29:17Z,1,0,1,1,0,1,0,1,{},0,1,{},
13921,2,2,2,2018-08-09T03:19:31Z,2018-08-10T01:44:33Z,1,0,1,1,0,2,2,0,"{'LD4': 1, 'LD1': 1}",2,0,"{'LD4': 1, 'LD1': 1}",
13929,2,2,2,2018-08-09T18:10:49Z,2018-08-09T18:56:19Z,1,0,1,1,0,1,0,2,{},0,1,{},
13933,1,0.001597444,1,2018-08-10T02:56:07Z,2020-04-27T00:48:03Z,626,625,1,0.001597444,1,1,1,0,{'LD4': 1},1,0,{'LD4': 1},Utils/log/libs
13934,6,1.2,3,2018-08-10T04:26:51Z,2018-08-14T04:35:57Z,5,3,2,0.4,2,3,4,2,"{'LD4': 3, 'LD1': 1}",2,1,"{'LD4': 2, 'LD1': 1}",Linux/Unix
13943,1,0.005181347,1,2018-08-11T12:52:04Z,2019-02-19T14:14:44Z,193,192,1,0.005181347,2,1,0,1,{},0,1,{},Brainstorming
13957,5,0.333333333,1.25,2018-08-13T16:07:21Z,2018-08-28T10:37:10Z,15,11,4,0.266666667,3,3,2,3,"{'LD4': 1, 'LD3': 1}",2,1,"{'LD4': 1, 'LD3': 1}",RPC/REST/ZMQ
13970,1,0.001851852,1,2018-08-14T19:27:53Z,2020-02-05T03:09:40Z,540,539,1,0.001851852,2,1,0,1,{},0,1,{},"Feature,GUI"
13973,7,7,7,2018-08-14T22:41:15Z,2018-08-15T15:23:24Z,1,0,1,1,0,3,4,3,"{'LD4': 2, 'LD3': 1, 'LD5': 1}",3,0,"{'LD4': 2, 'LD3': 1, 'LD5': 1}",Build system
13979,2,0.4,1,2018-08-15T11:23:00Z,2018-08-19T18:48:01Z,5,3,2,0.4,2,1,0,2,{},0,1,{},Windows
13991,2,0.03125,1,2018-08-16T19:24:53Z,2018-10-19T17:41:37Z,64,62,2,0.03125,3,2,0,2,{},0,2,{},Build system
13993,2,2,2,2018-08-17T14:55:33Z,2018-08-18T10:14:01Z,1,0,1,1,0,1,2,0,"{'LD4': 1, 'LD1': 1}",1,0,"{'LD4': 1, 'LD1': 1}",Windows
14041,11,1.833333333,2.75,2018-08-24T02:01:04Z,2018-08-29T11:00:29Z,6,2,4,0.666666667,1,4,5,6,"{'LD2': 1, 'LD4': 3, 'LD3': 1}",3,1,"{'LD2': 1, 'LD4': 2, 'LD3': 1}",Tests
14043,1,1,1,2018-08-24T05:54:15Z,2018-08-24T07:01:01Z,1,0,1,1,0,1,0,1,{},0,1,{},Windows
14044,1,0.001633987,1,2018-08-24T08:07:47Z,2020-04-26T22:30:21Z,612,611,1,0.001633987,1,1,1,0,{'LD4': 1},1,0,{'LD4': 1},Build system
14048,3,0.065217391,1.5,2018-08-24T10:48:26Z,2018-10-08T14:00:27Z,46,44,2,0.043478261,1,3,2,1,"{'LD1': 1, 'LD4': 1}",2,1,"{'LD1': 1, 'LD4': 1}",Docs
14058,3,0.033707865,3,2018-08-24T22:58:50Z,2018-11-20T23:18:42Z,89,88,1,0.011235955,2,1,0,3,{},0,1,{},Tests
14059,1,0.011764706,1,2018-08-24T23:03:47Z,2018-11-17T17:02:25Z,85,84,1,0.011764706,2,1,0,1,{},0,1,{},Tests
14061,1,1,1,2018-08-25T11:08:32Z,2018-08-25T13:41:18Z,1,0,1,1,0,1,1,0,{'LD1': 1},1,0,{'LD1': 1},Build system
14064,6,0.5,1.5,2018-08-25T23:04:44Z,2018-09-06T12:49:37Z,12,8,4,0.333333333,1,3,2,4,"{'LD4': 1, 'LD3': 1}",1,2,"{'LD4': 1, 'LD3': 1}",Utils/log/libs
14078,7,0.0875,3.5,2018-08-27T10:23:12Z,2018-11-14T15:53:34Z,80,78,2,0.025,1,4,2,5,"{'LD2': 1, 'LD1': 1}",2,2,"{'LD2': 1, 'LD1': 1}","GUI,Tests"
14095,1,0.25,1,2018-08-28T20:58:18Z,2018-09-01T09:08:03Z,4,3,1,0.25,2,1,1,0,{'LD4': 1},1,0,{'LD4': 1},Windows
14104,4,0.043956044,1.333333333,2018-08-30T08:39:59Z,2018-11-28T20:11:07Z,91,88,3,0.032967033,3,4,1,3,{'LD4': 1},1,3,{'LD4': 1},TX fees and policy
14109,1,0.166666667,1,2018-08-30T15:39:57Z,2018-09-04T19:49:13Z,6,5,1,0.166666667,2,1,0,1,{},0,1,{},Resource usage
14118,20,0.030349014,2,2018-08-31T11:17:47Z,2020-06-19T21:01:12Z,659,649,10,0.015174507,6,10,6,14,"{'LD3': 1, 'LD4': 2, 'LD6': 1, 'LD1': 1, 'LD5': 1}",6,4,"{'LD3': 1, 'LD4': 2, 'LD6': 1, 'LD1': 1, 'LD5': 1}","Build system,Windows"
14124,1,1,1,2018-08-31T22:40:20Z,2018-08-31T23:07:35Z,1,0,1,1,0,1,0,1,{},0,1,{},
14134,1,0.001848429,1,2018-09-02T22:41:19Z,2020-02-25T02:31:48Z,541,540,1,0.001848429,2,1,0,1,{},0,1,{},"GUI,Windows"
14163,5,0.033557047,1,2018-09-06T21:33:49Z,2019-02-01T22:26:12Z,149,144,5,0.033557047,5,3,0,5,{},0,3,{},Wallet
14173,4,0.088888889,1,2018-09-09T00:52:53Z,2018-10-23T23:06:34Z,45,41,4,0.088888889,5,3,3,1,"{'LD1': 1, 'LD2': 1, 'LD3': 1}",2,1,"{'LD1': 1, 'LD2': 1, 'LD3': 1}",RPC/REST/ZMQ
14187,1,0.001680672,1,2018-09-10T11:29:36Z,2020-04-26T22:33:10Z,595,594,1,0.001680672,2,1,0,1,{},0,1,{},Wallet
14198,3,0.005050505,1,2018-09-11T10:02:15Z,2020-04-26T12:24:03Z,594,591,3,0.005050505,3,2,2,1,{'LD1': 2},2,0,{'LD1': 2},Bug
14200,9,0.016605166,3,2018-09-11T20:53:57Z,2020-03-06T19:52:53Z,542,539,3,0.005535055,4,4,4,5,"{'LD4': 2, 'LD3': 2}",3,1,"{'LD4': 2, 'LD3': 1}","Bug,Windows"
14216,3,0.230769231,3,2018-09-13T22:02:32Z,2018-09-25T23:11:33Z,13,12,1,0.076923077,2,2,1,2,{'LD6': 1},1,1,{'LD6': 1},"Tests,good first issue"
14219,9,0.013782542,1.8,2018-09-14T12:09:45Z,2020-06-27T15:06:19Z,653,648,5,0.007656968,3,4,3,6,"{'LD3': 1, 'LD1': 2}",3,1,"{'LD3': 1, 'LD1': 2}",Windows
14229,1,1,1,2018-09-16T00:59:02Z,2018-09-16T12:34:38Z,1,0,1,1,0,1,1,0,{'LD1': 1},1,0,{'LD1': 1},
14261,5,1.666666667,1.666666667,2018-09-18T16:06:30Z,2018-09-21T12:19:57Z,3,0,3,1,0,3,4,1,"{'LD3': 2, 'LD1': 2}",2,1,"{'LD3': 1, 'LD1': 1}",Linux/Unix
14273,2,0.222222222,1,2018-09-19T21:43:37Z,2018-09-28T06:47:16Z,9,7,2,0.222222222,2,2,2,0,"{'LD1': 1, 'LD4': 1}",2,0,"{'LD1': 1, 'LD4': 1}","GUI,Upstream"
14277,4,0.006589786,2,2018-09-20T13:16:25Z,2020-05-19T11:26:55Z,607,605,2,0.003294893,2,2,0,4,{},0,2,{},"Brainstorming,Build system"
14280,6,0.461538462,1.5,2018-09-20T14:39:11Z,2018-10-02T23:12:18Z,13,9,4,0.307692308,1,3,6,0,"{'LD1': 4, 'LD4': 2}",3,0,"{'LD1': 3, 'LD4': 1}","Build system,Windows"
14294,3,3,3,2018-09-22T23:59:49Z,2018-09-23T16:34:11Z,1,0,1,1,0,3,2,1,"{'LD2': 1, 'LD1': 1}",2,1,"{'LD2': 1, 'LD1': 1}","Mempool,Questions and Help"
14299,7,0.225806452,2.333333333,2018-09-23T13:42:30Z,2018-10-23T22:18:40Z,31,28,3,0.096774194,2,4,2,5,{'LD3': 2},2,2,{'LD3': 2},"RPC/REST/ZMQ,Tests"
14301,1,0.004016064,1,2018-09-23T20:28:01Z,2019-05-29T21:50:16Z,249,248,1,0.004016064,2,1,0,1,{},0,1,{},macOS
14313,1,0.001724138,1,2018-09-24T21:01:28Z,2020-04-26T12:25:30Z,580,579,1,0.001724138,1,1,0,1,{},0,1,{},
14326,2,0.333333333,1,2018-09-26T10:39:27Z,2018-10-02T08:46:27Z,6,4,2,0.333333333,1,1,2,0,"{'LD4': 1, 'LD1': 1}",1,0,"{'LD4': 1, 'LD1': 1}",
14327,5,0.208333333,1.25,2018-09-26T12:49:57Z,2018-10-20T05:52:54Z,24,20,4,0.166666667,3,4,2,3,"{'LD2': 1, 'LD1': 1}",2,2,"{'LD2': 1, 'LD1': 1}",macOS
14330,4,0.012618297,2,2018-09-26T17:47:00Z,2019-08-09T16:02:54Z,317,315,2,0.006309148,2,1,1,3,{'LD4': 1},1,0,{'LD4': 1},Tests
14338,1,0.002074689,1,2018-09-27T06:28:32Z,2020-01-21T08:33:35Z,482,481,1,0.002074689,2,1,0,1,{},0,1,{},RPC/REST/ZMQ
14339,4,1.333333333,2,2018-09-27T08:36:32Z,2018-09-29T12:24:51Z,3,1,2,0.666666667,1,2,3,1,"{'LD4': 1, 'LD3': 1, 'LD6': 1}",2,0,"{'LD4': 1, 'LD3': 1, 'LD6': 1}","GUI,Linux/Unix"
14341,2,0.006644518,1,2018-09-27T17:04:11Z,2019-07-25T01:06:13Z,301,299,2,0.006644518,3,2,1,1,{'LD3': 1},1,1,{'LD3': 1},"Brainstorming,Consensus"
14345,2,0.086956522,1,2018-09-28T06:59:17Z,2018-10-20T08:33:39Z,23,21,2,0.086956522,2,2,2,0,"{'LD4': 1, 'LD1': 1}",2,0,"{'LD4': 1, 'LD1': 1}","Linux/Unix,Resource usage"
14349,2,0.090909091,1,2018-09-28T13:32:49Z,2018-10-20T04:13:08Z,22,20,2,0.090909091,2,2,1,1,{'LD2': 1},1,1,{'LD2': 1},macOS
14351,1,0.5,1,2018-09-29T04:46:08Z,2018-10-01T04:07:12Z,2,1,1,0.5,1,1,0,1,{},0,1,{},
14355,2,0.045454545,1,2018-09-30T01:57:33Z,2018-11-12T18:15:31Z,44,42,2,0.045454545,1,2,0,2,{},0,2,{},RPC/REST/ZMQ
14359,9,0.5625,1.5,2018-09-30T16:42:32Z,2018-10-16T05:05:35Z,16,10,6,0.375,2,4,3,6,"{'LD4': 1, 'LD2': 1, 'LD3': 1}",3,1,"{'LD4': 1, 'LD2': 1, 'LD3': 1}","GUI,Upstream"
14363,19,6.333333333,6.333333333,2018-10-02T00:34:21Z,2018-10-04T11:58:46Z,3,0,3,1,0,8,8,11,"{'LD3': 3, 'LD1': 3, 'LD4': 2}",6,2,"{'LD3': 2, 'LD1': 2, 'LD4': 2}",Brainstorming
14366,1,1,1,2018-10-02T11:04:52Z,2018-10-03T03:58:49Z,1,0,1,1,0,1,0,1,{},0,1,{},Questions and Help
14367,1,0.166666667,1,2018-10-02T12:02:31Z,2018-10-08T08:29:59Z,6,5,1,0.166666667,1,1,1,0,{'LD2': 1},1,0,{'LD2': 1},Build system
14371,1,1,1,2018-10-02T18:56:05Z,2018-10-02T21:03:02Z,1,0,1,1,0,1,0,1,{},0,1,{},
14376,7,0.4375,1.75,2018-10-03T03:56:03Z,2018-10-18T18:30:55Z,16,12,4,0.25,3,5,2,5,{'LD3': 2},2,3,{'LD3': 2},"Brainstorming,RPC/REST/ZMQ,Resource usage"
14378,9,0.138461538,3,2018-10-03T04:30:18Z,2018-12-06T21:50:15Z,65,62,3,0.046153846,4,4,4,5,"{'LD3': 1, 'LD6': 2, 'LD4': 1}",3,1,"{'LD3': 1, 'LD6': 2, 'LD4': 1}",RPC/REST/ZMQ
14382,3,0.069767442,1.5,2018-10-03T14:05:36Z,2018-11-14T17:01:19Z,43,41,2,0.046511628,2,3,1,2,{'LD3': 1},1,2,{'LD3': 1},"RPC/REST/ZMQ,Wallet"
14394,11,1.375,3.666666667,2018-10-04T16:28:10Z,2018-10-12T02:16:13Z,8,5,3,0.375,1,5,4,7,"{'LD3': 2, 'LD6': 1, 'LD4': 1}",4,1,"{'LD3': 2, 'LD6': 1, 'LD4': 1}",good first issue
14399,1,0.05,1,2018-10-05T07:49:04Z,2018-10-24T12:33:19Z,20,19,1,0.05,2,1,0,1,{},0,1,{},RPC/REST/ZMQ
14401,1,0.017241379,1,2018-10-05T08:22:52Z,2018-12-01T17:32:47Z,58,57,1,0.017241379,1,1,0,1,{},0,1,{},Bug
14404,11,0.020676692,1.222222222,2018-10-05T09:36:22Z,2020-03-19T14:50:44Z,532,523,9,0.016917293,8,7,3,8,"{'LD4': 1, 'LD3': 2}",3,4,"{'LD4': 1, 'LD3': 2}",Linux/Unix
14406,2,2,2,2018-10-05T10:44:19Z,2018-10-06T01:53:11Z,1,0,1,1,0,2,2,0,"{'LD4': 1, 'LD5': 1}",2,0,"{'LD4': 1, 'LD5': 1}",
14407,1,0.037037037,1,2018-10-05T12:50:28Z,2018-10-31T16:46:14Z,27,26,1,0.037037037,1,1,0,1,{},0,1,{},"Bug,Wallet"
14408,1,0.333333333,1,2018-10-05T16:09:27Z,2018-10-08T02:19:12Z,3,2,1,0.333333333,1,1,1,0,{'LD1': 1},1,0,{'LD1': 1},Windows
14414,9,0.45,1.285714286,2018-10-06T09:59:02Z,2018-10-26T01:11:17Z,20,13,7,0.35,5,6,3,6,"{'LD3': 2, 'LD2': 1}",3,3,"{'LD3': 2, 'LD2': 1}",macOS
14415,2,0.058823529,1,2018-10-06T10:27:59Z,2018-11-08T17:50:53Z,34,32,2,0.058823529,2,2,1,1,{'LD5': 1},1,1,{'LD5': 1},"Bug,Wallet"
14420,1,0.071428571,1,2018-10-07T02:04:32Z,2018-10-20T13:51:58Z,14,13,1,0.071428571,2,1,0,1,{},0,1,{},RPC/REST/ZMQ
14422,11,0.01754386,1.375,2018-10-07T05:25:38Z,2020-06-24T17:22:54Z,627,619,8,0.012759171,8,8,4,7,"{'LD4': 3, 'LD6': 1}",3,5,"{'LD4': 2, 'LD6': 1}",Wallet
14423,2,0.333333333,1,2018-10-07T05:25:44Z,2018-10-12T23:15:21Z,6,4,2,0.333333333,1,1,2,0,{'LD1': 2},1,0,{'LD1': 1},
14429,2,0.003527337,1,2018-10-08T00:00:24Z,2020-04-26T12:27:05Z,567,565,2,0.003527337,3,2,1,1,{'LD4': 1},1,1,{'LD4': 1},Wallet
14432,3,1.5,3,2018-10-08T14:06:12Z,2018-10-10T06:18:31Z,2,1,1,0.5,1,3,2,1,"{'LD1': 1, 'LD4': 1}",2,1,"{'LD1': 1, 'LD4': 1}",Windows
14435,1,1,1,2018-10-08T22:01:29Z,2018-10-08T23:14:50Z,1,0,1,1,0,1,1,0,{'LD5': 1},1,0,{'LD5': 1},GUI
14438,17,0.083333333,1.133333333,2018-10-09T04:13:11Z,2019-04-30T12:59:04Z,204,189,15,0.073529412,13,4,1,16,{'LD4': 1},1,3,{'LD4': 1},good first issue
14445,1,1,1,2018-10-09T12:56:51Z,2018-10-10T02:10:23Z,1,0,1,1,0,1,1,0,{'LD2': 1},1,0,{'LD2': 1},
14446,8,0.057142857,1.142857143,2018-10-09T16:34:50Z,2019-02-25T16:46:04Z,140,133,7,0.05,7,5,2,6,"{'LD1': 1, 'LD5': 1}",2,3,"{'LD1': 1, 'LD5': 1}","Tests,Windows"
14452,1,0.066666667,1,2018-10-09T22:31:27Z,2018-10-24T14:46:23Z,15,14,1,0.066666667,1,1,0,1,{},0,1,{},RPC/REST/ZMQ
14461,4,0.007092199,1.333333333,2018-10-10T22:53:38Z,2020-04-26T12:28:29Z,564,561,3,0.005319149,1,3,0,4,{},0,3,{},"Data corruption,Wallet"
14462,3,3,3,2018-10-11T10:27:40Z,2018-10-11T17:01:48Z,1,0,1,1,0,1,1,2,{'LD3': 1},1,0,{'LD3': 1},
14466,11,0.019503546,1.571428571,2018-10-12T00:06:49Z,2020-04-27T00:52:15Z,564,557,7,0.012411348,3,5,10,1,"{'LD4': 4, 'LD3': 2, 'LD1': 3, 'LD2': 1}",5,0,"{'LD4': 4, 'LD3': 2, 'LD1': 2, 'LD2': 1}",Linux/Unix
14469,3,0.142857143,1.5,2018-10-12T21:45:25Z,2018-11-02T07:32:39Z,21,19,2,0.095238095,2,3,2,1,{'LD3': 2},2,1,{'LD3': 2},"GUI,macOS"
14473,2,0.071428571,2,2018-10-13T08:31:03Z,2018-11-10T03:44:23Z,28,27,1,0.035714286,1,2,1,1,{'LD3': 1},1,1,{'LD3': 1},RPC/REST/ZMQ
14482,2,0.00990099,2,2018-10-15T07:33:21Z,2019-05-04T23:26:33Z,202,201,1,0.004950495,1,1,0,2,{},0,1,{},"GUI,Hacktoberfest,good first issue"
14483,2,2,2,2018-10-15T08:12:33Z,2018-10-15T12:28:21Z,1,0,1,1,0,1,1,1,{'LD1': 1},1,0,{'LD1': 1},RPC/REST/ZMQ
14488,1,1,1,2018-10-15T17:32:21Z,2018-10-15T19:10:36Z,1,0,1,1,0,1,0,1,{},0,1,{},
14499,2,0.2,1,2018-10-16T23:26:26Z,2018-10-26T11:22:47Z,10,8,2,0.2,2,1,1,1,{'LD3': 1},1,0,{'LD3': 1},RPC/REST/ZMQ
14500,2,2,2,2018-10-17T08:22:44Z,2018-10-17T08:59:21Z,1,0,1,1,0,2,1,1,{'LD1': 1},1,1,{'LD1': 1},
14503,3,0.071428571,3,2018-10-17T15:21:43Z,2018-11-27T20:23:46Z,42,41,1,0.023809524,1,1,2,1,{'LD1': 2},1,0,{'LD1': 1},RPC/REST/ZMQ
14514,6,0.171428571,2,2018-10-18T22:54:17Z,2018-11-22T02:17:11Z,35,32,3,0.085714286,1,5,4,2,"{'LD4': 1, 'LD1': 1, 'LD3': 1, 'LD5': 1}",3,2,"{'LD4': 1, 'LD1': 1, 'LD3': 1, 'LD5': 1}","Brainstorming,Feature,Scripts and tools"
14516,1,1,1,2018-10-19T06:59:20Z,2018-10-19T07:54:04Z,1,0,1,1,0,1,1,0,{'LD2': 1},1,0,{'LD2': 1},
14520,1,1,1,2018-10-19T16:56:59Z,2018-10-19T17:17:28Z,1,0,1,1,0,1,1,0,{'LD2': 1},1,0,{'LD2': 1},
14523,4,0.023121387,1.333333333,2018-10-19T21:48:31Z,2019-04-10T01:19:19Z,173,170,3,0.01734104,3,2,2,2,"{'LD3': 1, 'LD1': 1}",1,1,"{'LD3': 1, 'LD1': 1}","Bug,Utils/log/libs"
14525,1,1,1,2018-10-20T03:51:38Z,2018-10-20T13:50:00Z,1,0,1,1,0,1,0,1,{},0,1,{},"Brainstorming,Consensus"
14535,2,2,2,2018-10-21T10:36:58Z,2018-10-21T11:04:07Z,1,0,1,1,0,2,1,1,{'LD2': 1},1,1,{'LD2': 1},
14536,3,0.005415162,1,2018-10-21T13:45:03Z,2020-04-27T01:38:35Z,554,551,3,0.005415162,4,2,0,3,{},0,2,{},"Tests,Wallet"
14538,14,0.466666667,4.666666667,2018-10-21T18:54:09Z,2018-11-20T14:17:21Z,30,27,3,0.1,2,4,5,9,"{'LD4': 1, 'LD6': 1, 'LD1': 1, 'LD5': 2}",3,1,"{'LD4': 1, 'LD6': 1, 'LD1': 1, 'LD5': 2}",Wallet
14544,1,1,1,2018-10-23T00:05:21Z,2018-10-23T12:44:59Z,1,0,1,1,0,1,0,1,{},0,1,{},Questions and Help
14546,1,1,1,2018-10-23T03:49:21Z,2018-10-23T20:25:14Z,1,0,1,1,0,1,1,0,{'LD4': 1},1,0,{'LD4': 1},Linux/Unix
14548,1,0.00212766,1,2018-10-23T05:01:30Z,2020-02-04T10:09:24Z,470,469,1,0.00212766,2,1,0,1,{},0,1,{},Windows
14550,1,0.00212766,1,2018-10-23T05:06:57Z,2020-02-04T10:06:21Z,470,469,1,0.00212766,1,1,0,1,{},0,1,{},GUI
14557,7,0.064220183,1.166666667,2018-10-23T19:34:05Z,2019-02-09T16:26:52Z,109,103,6,0.055045872,4,3,4,3,{'LD4': 4},1,2,{'LD4': 1},"Block storage,Utils/log/libs"
14572,7,0.031674208,1.75,2018-10-25T14:44:27Z,2019-06-02T21:39:25Z,221,217,4,0.018099548,3,2,1,6,{'LD5': 1},1,1,{'LD5': 1},
14574,2,0.003642987,2,2018-10-25T17:19:32Z,2020-04-26T12:33:38Z,549,548,1,0.001821494,1,1,1,1,{'LD5': 1},1,0,{'LD5': 1},
14578,3,0.6,1,2018-10-25T23:50:15Z,2018-10-30T19:38:47Z,5,2,3,0.6,2,2,2,1,"{'LD4': 1, 'LD3': 1}",2,0,"{'LD4': 1, 'LD3': 1}",RPC/REST/ZMQ
14580,18,0.08411215,2.25,2018-10-26T03:28:43Z,2019-05-27T12:59:20Z,214,206,8,0.037383178,8,6,5,13,"{'LD3': 2, 'LD6': 1, 'LD4': 1, 'LD5': 1}",4,2,"{'LD3': 2, 'LD6': 1, 'LD4': 1, 'LD5': 1}",Tests
14586,2,0.006993007,1,2018-10-26T20:15:58Z,2019-08-07T20:57:24Z,286,284,2,0.006993007,3,2,0,2,{},0,2,{},Upstream
14595,3,0.04,1,2018-10-28T17:12:49Z,2019-01-11T12:15:34Z,75,72,3,0.04,4,1,1,2,{'LD4': 1},1,0,{'LD4': 1},
14598,1,0.090909091,1,2018-10-29T06:38:53Z,2018-11-08T08:00:25Z,11,10,1,0.090909091,2,1,1,0,{'LD4': 1},1,0,{'LD4': 1},Windows
14603,5,2.5,2.5,2018-10-29T18:46:39Z,2018-10-31T00:36:24Z,2,0,2,1,0,4,5,0,"{'LD2': 1, 'LD1': 4}",4,0,"{'LD2': 1, 'LD1': 3}",Wallet
14607,4,0.125,2,2018-10-30T12:11:46Z,2018-11-30T21:05:16Z,32,30,2,0.0625,2,3,3,1,"{'LD1': 1, 'LD4': 2}",3,0,"{'LD1': 1, 'LD4': 2}","Questions and Help,RPC/REST/ZMQ"
14614,1,1,1,2018-10-31T03:10:12Z,2018-10-31T05:26:54Z,1,0,1,1,0,1,0,1,{},0,1,{},
14616,4,0.007326007,1.333333333,2018-10-31T08:10:39Z,2020-04-29T04:35:56Z,546,543,3,0.005494505,1,2,3,1,{'LD4': 3},2,0,{'LD4': 2},Linux/Unix
14622,3,3,3,2018-10-31T20:42:03Z,2018-11-01T17:25:43Z,1,0,1,1,0,3,1,2,{'LD3': 1},1,2,{'LD3': 1},Privacy
14623,4,0.014285714,1,2018-10-31T21:56:28Z,2019-08-07T20:44:50Z,280,276,4,0.014285714,5,4,0,4,{},0,4,{},Brainstorming
14627,9,0.9,3,2018-11-01T01:10:26Z,2018-11-10T09:59:44Z,10,7,3,0.3,2,5,4,5,"{'LD1': 1, 'LD4': 2, 'LD5': 1}",4,1,"{'LD1': 1, 'LD4': 2, 'LD5': 1}",RPC/REST/ZMQ
14634,4,0.057971014,4,2018-11-01T18:53:45Z,2019-01-08T23:25:06Z,69,68,1,0.014492754,1,1,2,2,{'LD1': 2},1,0,{'LD1': 1},
14642,1,0.001848429,1,2018-11-02T14:54:52Z,2020-04-26T12:38:16Z,541,540,1,0.001848429,2,1,1,0,{'LD3': 1},1,0,{'LD3': 1},"Feature,RPC/REST/ZMQ"
14645,1,1,1,2018-11-03T01:44:00Z,2018-11-03T01:50:38Z,1,0,1,1,0,1,0,1,{},0,1,{},"Questions and Help,RPC/REST/ZMQ"
14648,1,0.00990099,1,2018-11-03T10:07:22Z,2019-02-12T02:11:10Z,101,100,1,0.00990099,2,1,1,0,{'LD4': 1},1,0,{'LD4': 1},"Build system,macOS"
14652,1,0.5,1,2018-11-04T10:16:04Z,2018-11-05T16:44:26Z,2,1,1,0.5,1,1,1,0,{'LD1': 1},1,0,{'LD1': 1},"Questions and Help,Windows"
14656,3,3,3,2018-11-05T08:31:53Z,2018-11-06T04:11:01Z,1,0,1,1,0,2,1,2,{'LD4': 1},1,1,{'LD4': 1},"RPC/REST/ZMQ,Wallet"
14657,2,2,2,2018-11-05T13:10:28Z,2018-11-05T14:06:32Z,1,0,1,1,0,2,1,1,{'LD2': 1},1,1,{'LD2': 1},RPC/REST/ZMQ
14669,1,0.001862197,1,2018-11-06T14:47:18Z,2020-04-26T12:40:49Z,537,536,1,0.001862197,2,1,1,0,{'LD1': 1},1,0,{'LD1': 1},Linux/Unix
14675,1,1,1,2018-11-07T03:31:19Z,2018-11-07T16:09:25Z,1,0,1,1,0,1,1,0,{'LD1': 1},1,0,{'LD1': 1},"GUI,Linux/Unix"
14676,6,0.010928962,1.2,2018-11-07T10:13:53Z,2020-05-08T23:19:42Z,549,544,5,0.009107468,5,3,1,5,{'LD4': 1},1,2,{'LD4': 1},"Brainstorming,Docs"
14677,2,1,2,2018-11-07T10:33:40Z,2018-11-08T13:27:02Z,2,1,1,0.5,1,2,1,1,{'LD1': 1},1,1,{'LD1': 1},Windows
14681,5,0.009328358,2.5,2018-11-07T16:47:52Z,2020-04-26T12:59:18Z,536,534,2,0.003731343,2,3,3,2,"{'LD1': 2, 'LD3': 1}",2,1,"{'LD1': 2, 'LD3': 1}","Questions and Help,RPC/REST/ZMQ"
14697,2,0.058823529,1,2018-11-09T13:18:20Z,2018-12-12T15:27:00Z,34,32,2,0.058823529,2,2,2,0,"{'LD6': 1, 'LD3': 1}",2,0,"{'LD6': 1, 'LD3': 1}",macOS
14699,4,0.102564103,2,2018-11-09T19:35:31Z,2018-12-18T17:31:58Z,39,37,2,0.051282051,3,3,1,3,{'LD6': 1},1,2,{'LD6': 1},"Docs,good first issue"
14703,3,0.014285714,1,2018-11-10T10:29:06Z,2019-06-07T12:01:21Z,210,207,3,0.014285714,3,3,1,2,{'LD4': 1},1,2,{'LD4': 1},GUI
14709,1,1,1,2018-11-12T07:35:21Z,2018-11-12T16:31:01Z,1,0,1,1,0,1,0,1,{},0,1,{},Tests
14710,1,0.066666667,1,2018-11-12T16:03:24Z,2018-11-26T21:16:34Z,15,14,1,0.066666667,2,1,0,1,{},0,1,{},Tests
14717,2,0.003766478,1,2018-11-13T12:39:58Z,2020-04-26T13:00:03Z,531,529,2,0.003766478,2,2,2,0,"{'LD1': 1, 'LD4': 1}",2,0,"{'LD1': 1, 'LD4': 1}",
14723,1,0.014705882,1,2018-11-13T22:54:15Z,2019-01-19T23:54:40Z,68,67,1,0.014705882,1,1,0,1,{},0,1,{},"GUI,Linux/Unix"
14727,2,0.5,1,2018-11-14T03:19:41Z,2018-11-17T06:21:40Z,4,2,2,0.5,1,2,1,1,{'LD1': 1},1,1,{'LD1': 1},macOS
14730,1,1,1,2018-11-15T15:14:38Z,2018-11-15T19:05:11Z,1,0,1,1,0,1,0,1,{},0,1,{},
14732,1,0.022727273,1,2018-11-15T22:27:25Z,2018-12-29T17:21:39Z,44,43,1,0.022727273,1,1,0,1,{},0,1,{},"Tests,good first issue"
14736,1,1,1,2018-11-16T14:40:51Z,2018-11-16T16:24:01Z,1,0,1,1,0,1,1,0,{'LD1': 1},1,0,{'LD1': 1},
14748,1,0.142857143,1,2018-11-17T20:06:25Z,2018-11-24T07:51:39Z,7,6,1,0.142857143,2,1,0,1,{},0,1,{},Linux/Unix
14750,4,0.173913043,1.333333333,2018-11-17T22:08:14Z,2018-12-10T06:10:50Z,23,20,3,0.130434783,3,2,2,2,"{'LD3': 1, 'LD2': 1}",1,1,"{'LD3': 1, 'LD2': 1}","Data corruption,Linux/Unix"
14751,1,1,1,2018-11-18T10:09:39Z,2018-11-18T10:20:50Z,1,0,1,1,0,1,0,1,{},0,1,{},macOS
14754,2,2,2,2018-11-18T19:38:11Z,2018-11-19T15:21:47Z,1,0,1,1,0,2,2,0,"{'LD1': 1, 'LD2': 1}",2,0,"{'LD1': 1, 'LD2': 1}",GUI
14758,2,0.008474576,1,2018-11-19T15:56:22Z,2019-07-12T19:29:50Z,236,234,2,0.008474576,2,2,0,2,{},0,2,{},Tests
14765,4,0.02259887,2,2018-11-19T21:20:28Z,2019-05-15T15:34:42Z,177,175,2,0.011299435,2,4,1,3,{'LD6': 1},1,3,{'LD6': 1},"RPC/REST/ZMQ,Resource usage,Utils/log/libs"
14769,1,0.5,1,2018-11-20T10:45:40Z,2018-11-22T05:50:23Z,2,1,1,0.5,1,1,1,0,{'LD1': 1},1,0,{'LD1': 1},
14779,2,2,2,2018-11-22T02:17:29Z,2018-11-22T05:13:12Z,1,0,1,1,0,2,0,2,{},0,2,{},RPC/REST/ZMQ
14792,1,0.083333333,1,2018-11-23T08:40:10Z,2018-12-04T12:08:56Z,12,11,1,0.083333333,2,1,0,1,{},0,1,{},"Bug,Tests,good first issue"
14793,1,1,1,2018-11-23T10:09:43Z,2018-11-24T07:49:59Z,1,0,1,1,0,1,0,1,{},0,1,{},macOS
14814,1,0.002487562,1,2018-11-26T21:17:50Z,2020-01-02T16:53:19Z,402,401,1,0.002487562,2,1,1,0,{'LD3': 1},1,0,{'LD3': 1},"Tests,good first issue"
14815,6,0.007682458,1.5,2018-11-26T21:44:12Z,2021-01-15T06:21:25Z,781,777,4,0.005121639,4,6,2,4,"{'LD3': 1, 'LD5': 1}",2,4,"{'LD3': 1, 'LD5': 1}","Brainstorming,RPC/REST/ZMQ"
14830,3,0.011583012,1.5,2018-11-28T20:41:55Z,2019-08-14T20:08:37Z,259,257,2,0.007722008,2,3,1,2,{'LD3': 1},1,2,{'LD3': 1},"Build system,good first issue"
14850,1,0.001945525,1,2018-11-30T14:45:21Z,2020-04-26T16:16:39Z,514,513,1,0.001945525,2,1,0,1,{},0,1,{},Wallet
14859,3,0.012048193,1.5,2018-12-03T04:54:31Z,2019-08-08T14:35:21Z,249,247,2,0.008032129,3,2,1,2,{'LD1': 1},1,1,{'LD1': 1},Feature
14867,1,0.25,1,2018-12-04T11:53:59Z,2018-12-07T16:02:05Z,4,3,1,0.25,1,1,1,0,{'LD2': 1},1,0,{'LD2': 1},
14868,3,0.75,1.5,2018-12-04T12:35:05Z,2018-12-07T16:21:28Z,4,2,2,0.5,2,1,1,2,{'LD2': 1},1,0,{'LD2': 1},
14870,8,0.01532567,2.666666667,2018-12-04T17:12:49Z,2020-05-08T23:20:11Z,522,519,3,0.005747126,2,5,4,4,"{'LD4': 2, 'LD3': 1, 'LD1': 1}",3,2,"{'LD4': 2, 'LD3': 1, 'LD1': 1}",Resource usage
14874,1,0.002666667,1,2018-12-05T14:16:32Z,2019-12-15T09:07:02Z,375,374,1,0.002666667,1,1,0,1,{},0,1,{},Brainstorming
14891,1,1,1,2018-12-06T22:51:37Z,2018-12-07T22:44:10Z,1,0,1,1,0,1,1,0,{'LD4': 1},1,0,{'LD4': 1},
14896,5,1.25,2.5,2018-12-08T01:43:43Z,2018-12-11T16:27:58Z,4,2,2,0.5,1,2,2,3,{'LD4': 2},1,1,{'LD4': 1},Wallet
14901,1,1,1,2018-12-09T17:42:20Z,2018-12-10T06:51:42Z,1,0,1,1,0,1,1,0,{'LD1': 1},1,0,{'LD1': 1},macOS
14902,7,0.5,1.4,2018-12-09T18:48:54Z,2018-12-23T02:47:50Z,14,9,5,0.357142857,5,3,0,7,{},0,3,{},"Brainstorming,Tests"
14904,2,0.004761905,2,2018-12-10T01:54:47Z,2020-02-03T01:18:43Z,420,419,1,0.002380952,1,2,0,2,{},0,2,{},Block storage
14907,8,0.015503876,4,2018-12-10T06:48:35Z,2020-05-08T23:23:20Z,516,514,2,0.003875969,1,2,0,8,{},0,2,{},Wallet
14917,1,0.027777778,1,2018-12-10T20:37:33Z,2019-01-15T13:39:18Z,36,35,1,0.027777778,1,1,0,1,{},0,1,{},"Tests,good first issue"
14921,2,2,2,2018-12-11T11:06:27Z,2018-12-12T04:11:09Z,1,0,1,1,0,2,2,0,"{'LD2': 1, 'LD3': 1}",2,0,"{'LD2': 1, 'LD3': 1}",
14923,2,2,2,2018-12-11T16:59:56Z,2018-12-11T22:55:46Z,1,0,1,1,0,2,1,1,{'LD2': 1},1,1,{'LD2': 1},GUI
14927,7,0.013592233,3.5,2018-12-11T18:39:36Z,2020-05-08T23:23:47Z,515,513,2,0.003883495,1,3,1,6,{'LD2': 1},1,2,{'LD2': 1},Wallet
14928,1,0.001930502,1,2018-12-11T18:56:00Z,2020-05-11T23:29:51Z,518,517,1,0.001930502,1,1,1,0,{'LD4': 1},1,0,{'LD4': 1},Wallet
14933,2,0.095238095,1,2018-12-12T05:24:37Z,2019-01-01T10:43:03Z,21,19,2,0.095238095,2,1,1,1,{'LD1': 1},1,0,{'LD1': 1},"Block storage,Data corruption"
14943,2,0.003976143,1,2018-12-13T02:11:05Z,2020-04-28T12:39:27Z,503,501,2,0.003976143,2,2,0,2,{},0,2,{},
14948,11,0.035947712,1.375,2018-12-13T13:58:38Z,2019-10-15T11:12:36Z,306,298,8,0.026143791,5,7,4,7,"{'LD4': 1, 'LD3': 2, 'LD5': 1}",3,4,"{'LD4': 1, 'LD3': 2, 'LD5': 1}","Linux/Unix,Tests"
14959,1,0.002512563,1,2018-12-14T13:02:30Z,2020-01-16T07:36:33Z,398,397,1,0.002512563,2,1,0,1,{},0,1,{},Build system
14962,3,0.230769231,1,2018-12-14T20:04:00Z,2018-12-27T06:52:08Z,13,10,3,0.230769231,1,3,0,3,{},0,3,{},"Brainstorming,Docs"
14967,1,0.5,1,2018-12-15T06:45:35Z,2018-12-16T11:15:24Z,2,1,1,0.5,1,1,0,1,{},0,1,{},Tests
14971,4,0.017021277,4,2018-12-16T05:56:47Z,2019-08-07T20:43:37Z,235,234,1,0.004255319,1,2,3,1,"{'LD1': 2, 'LD3': 1}",1,1,"{'LD1': 1, 'LD3': 1}",Windows
14976,4,1,1.333333333,2018-12-16T20:52:40Z,2018-12-19T21:11:22Z,4,1,3,0.75,1,3,2,2,"{'LD4': 1, 'LD3': 1}",2,1,"{'LD4': 1, 'LD3': 1}",macOS
14983,12,0.255319149,12,2018-12-17T14:47:31Z,2019-02-01T18:08:46Z,47,46,1,0.021276596,1,6,2,10,"{'LD3': 1, 'LD6': 1}",2,4,"{'LD3': 1, 'LD6': 1}","GUI,Tests"
14986,4,0.008,1,2018-12-17T17:07:49Z,2020-04-29T23:42:23Z,500,496,4,0.008,3,4,2,2,{'LD3': 2},2,2,{'LD3': 2},Scripts and tools
14992,1,0.001663894,1,2018-12-18T10:06:14Z,2020-08-10T07:11:46Z,601,600,1,0.001663894,1,1,0,1,{},0,1,{},GUI
14994,2,0.125,1,2018-12-18T14:05:43Z,2019-01-02T16:19:47Z,16,14,2,0.125,2,2,1,1,{'LD3': 1},1,1,{'LD3': 1},Linux/Unix
14995,5,0.010504202,2.5,2018-12-18T14:26:46Z,2020-04-06T18:29:53Z,476,474,2,0.004201681,2,2,4,1,"{'LD4': 1, 'LD1': 2, 'LD3': 1}",2,0,"{'LD4': 1, 'LD1': 2, 'LD3': 1}",RPC/REST/ZMQ
14999,1,0.002016129,1,2018-12-18T23:24:16Z,2020-04-27T00:55:04Z,496,495,1,0.002016129,1,1,1,0,{'LD2': 1},1,0,{'LD2': 1},
15001,2,0.074074074,2,2018-12-19T09:06:33Z,2019-01-14T12:28:19Z,27,26,1,0.037037037,2,1,1,1,{'LD3': 1},1,0,{'LD3': 1},RPC/REST/ZMQ
15008,1,0.001652893,1,2018-12-20T02:07:13Z,2020-08-15T02:22:19Z,605,604,1,0.001652893,1,1,0,1,{},0,1,{},GUI
15009,3,0.005928854,1.5,2018-12-20T02:50:55Z,2020-05-08T23:24:07Z,506,504,2,0.003952569,1,3,2,1,"{'LD3': 1, 'LD6': 1}",2,1,"{'LD3': 1, 'LD6': 1}","Build system,Upstream"
15011,2,1,2,2018-12-20T17:40:03Z,2018-12-21T21:47:29Z,2,1,1,0.5,1,2,0,2,{},0,2,{},
15015,6,0.012847966,1.5,2018-12-21T12:51:31Z,2020-04-01T10:56:04Z,467,463,4,0.00856531,4,4,3,3,"{'LD3': 1, 'LD4': 1, 'LD1': 1}",3,1,"{'LD3': 1, 'LD4': 1, 'LD1': 1}",GUI
15016,2,0.071428571,1,2018-12-21T14:00:10Z,2019-01-17T21:18:01Z,28,26,2,0.071428571,2,1,1,1,{'LD1': 1},1,0,{'LD1': 1},"GUI,macOS"
15027,3,0.00610998,3,2018-12-22T18:57:59Z,2020-04-26T15:19:38Z,491,490,1,0.00203666,2,2,2,1,"{'LD5': 1, 'LD4': 1}",2,0,"{'LD5': 1, 'LD4': 1}","GUI,Wallet"
15030,3,0.018518519,1,2018-12-23T06:03:06Z,2019-06-02T21:45:30Z,162,159,3,0.018518519,3,2,0,3,{},0,2,{},Wallet
15034,2,0.012121212,2,2018-12-25T10:51:50Z,2019-06-07T11:58:00Z,165,164,1,0.006060606,2,1,1,1,{'LD4': 1},1,0,{'LD4': 1},GUI
15037,4,0.142857143,2,2018-12-26T08:14:18Z,2019-01-22T10:58:17Z,28,26,2,0.071428571,2,3,0,4,{},0,3,{},Questions and Help
15041,2,0.25,1,2018-12-27T07:59:55Z,2019-01-03T10:53:18Z,8,6,2,0.25,2,2,1,1,{'LD5': 1},1,1,{'LD5': 1},Docs
15046,3,0.010752688,1,2018-12-27T20:47:03Z,2019-10-02T14:08:17Z,279,276,3,0.010752688,4,2,1,2,{'LD4': 1},1,1,{'LD4': 1},Mempool
15048,6,0.039473684,3,2018-12-28T01:51:44Z,2019-05-28T20:29:23Z,152,150,2,0.013157895,1,5,3,3,"{'LD3': 2, 'LD4': 1}",3,2,"{'LD3': 2, 'LD4': 1}",
15049,1,0.090909091,1,2018-12-28T09:00:03Z,2019-01-07T13:34:44Z,11,10,1,0.090909091,2,1,0,1,{},0,1,{},Windows
15058,2,2,2,2018-12-29T17:57:29Z,2018-12-30T00:45:54Z,1,0,1,1,0,1,0,2,{},0,1,{},
15062,2,0.004132231,2,2018-12-30T05:52:06Z,2020-04-26T15:19:52Z,484,483,1,0.002066116,2,1,1,1,{'LD4': 1},1,0,{'LD4': 1},Linux/Unix
15066,1,1,1,2018-12-30T12:12:10Z,2018-12-30T13:36:52Z,1,0,1,1,0,1,0,1,{},0,1,{},
15079,5,2.5,2.5,2019-01-02T14:49:08Z,2019-01-04T09:27:07Z,2,0,2,1,0,4,1,4,{'LD4': 1},1,3,{'LD4': 1},GUI
15080,3,0.020408163,1,2019-01-02T17:00:26Z,2019-05-29T11:08:45Z,147,144,3,0.020408163,3,3,0,3,{},0,3,{},"Brainstorming,Mempool"
15089,1,1,1,2019-01-03T12:41:18Z,2019-01-03T23:11:03Z,1,0,1,1,0,1,0,1,{},0,1,{},Windows
15092,2,0.013793103,2,2019-01-03T22:02:29Z,2019-05-28T20:33:37Z,145,144,1,0.006896552,1,2,1,1,{'LD3': 1},1,1,{'LD3': 1},Windows
15095,3,0.75,3,2019-01-04T00:21:43Z,2019-01-07T09:34:10Z,4,3,1,0.25,1,2,0,3,{},0,2,{},Consensus
15096,2,0.095238095,1,2019-01-04T05:12:05Z,2019-01-24T10:10:17Z,21,19,2,0.095238095,2,2,1,1,{'LD3': 1},1,1,{'LD3': 1},Questions and Help
15097,2,0.002699055,1,2019-01-04T07:22:18Z,2021-01-14T05:44:15Z,741,739,2,0.002699055,2,2,2,0,"{'LD4': 1, 'LD3': 1}",2,0,"{'LD4': 1, 'LD3': 1}",Wallet
15106,1,0.038461538,1,2019-01-04T21:38:03Z,2019-01-30T19:23:48Z,26,25,1,0.038461538,2,1,0,1,{},0,1,{},GUI
15113,2,0.004192872,1,2019-01-06T00:14:32Z,2020-04-26T11:44:19Z,477,475,2,0.004192872,2,1,1,1,{'LD2': 1},1,0,{'LD2': 1},"Data corruption,macOS"
15116,2,0.004192872,1,2019-01-06T14:43:21Z,2020-04-26T15:21:28Z,477,475,2,0.004192872,3,2,0,2,{},0,2,{},
15119,1,1,1,2019-01-07T09:38:59Z,2019-01-07T10:01:45Z,1,0,1,1,0,1,1,0,{'LD1': 1},1,0,{'LD1': 1},
15121,1,1,1,2019-01-07T11:18:11Z,2019-01-07T11:38:51Z,1,0,1,1,0,1,0,1,{},0,1,{},
15125,3,1.5,3,2019-01-08T08:06:43Z,2019-01-09T09:21:57Z,2,1,1,0.5,1,3,2,1,"{'LD1': 1, 'LD2': 1}",2,1,"{'LD1': 1, 'LD2': 1}",Wallet
15131,2,0.117647059,1,2019-01-08T19:29:22Z,2019-01-25T00:10:59Z,17,15,2,0.117647059,3,1,2,0,{'LD1': 2},1,0,{'LD1': 1},Windows
15142,4,0.307692308,1.333333333,2019-01-10T17:20:58Z,2019-01-22T21:54:19Z,13,10,3,0.230769231,4,3,0,4,{},0,3,{},"Bug,GUI,macOS"
15145,2,0.004040404,2,2019-01-10T20:35:52Z,2020-05-19T11:49:22Z,495,494,1,0.002020202,2,1,0,2,{},0,1,{},Build system
15161,1,1,1,2019-01-14T11:36:53Z,2019-01-14T14:45:02Z,1,0,1,1,0,1,0,1,{},0,1,{},Docs
15168,2,0.5,1,2019-01-15T00:48:40Z,2019-01-18T08:30:14Z,4,2,2,0.5,1,2,0,2,{},0,2,{},"RPC/REST/ZMQ,macOS"
15172,3,0.214285714,1,2019-01-15T10:07:00Z,2019-01-28T15:42:54Z,14,11,3,0.214285714,2,2,2,1,"{'LD3': 1, 'LD2': 1}",2,0,"{'LD3': 1, 'LD2': 1}",Linux/Unix
15184,1,0.014084507,1,2019-01-16T20:11:04Z,2019-03-27T23:27:31Z,71,70,1,0.014084507,1,1,1,0,{'LD4': 1},1,0,{'LD4': 1},Questions and Help
15211,1,0.002159827,1,2019-01-20T02:47:51Z,2020-04-26T15:22:12Z,463,462,1,0.002159827,2,1,1,0,{'LD4': 1},1,0,{'LD4': 1},RPC/REST/ZMQ
15227,3,0.75,3,2019-01-22T05:45:44Z,2019-01-25T06:15:00Z,4,3,1,0.25,2,2,1,2,{'LD3': 1},1,1,{'LD3': 1},macOS
15229,2,0.086956522,1,2019-01-22T10:17:32Z,2019-02-14T01:38:08Z,23,21,2,0.086956522,3,1,0,2,{},0,1,{},
15230,1,0.002173913,1,2019-01-22T22:33:46Z,2020-04-26T15:24:02Z,460,459,1,0.002173913,2,1,1,0,{'LD3': 1},1,0,{'LD3': 1},GUI
15232,1,1,1,2019-01-23T00:17:08Z,2019-01-23T00:44:41Z,1,0,1,1,0,1,0,1,{},0,1,{},
15234,1,1,1,2019-01-23T05:50:22Z,2019-01-23T10:51:03Z,1,0,1,1,0,1,1,0,{'LD2': 1},1,0,{'LD2': 1},
15237,3,0.006521739,1,2019-01-23T12:43:18Z,2020-04-26T15:24:52Z,460,457,3,0.006521739,2,3,1,2,{'LD1': 1},1,2,{'LD1': 1},"Brainstorming,GUI"
15240,4,0.019230769,1,2019-01-24T04:04:11Z,2019-08-19T14:03:45Z,208,204,4,0.019230769,5,2,3,1,"{'LD4': 2, 'LD1': 1}",2,0,"{'LD4': 2, 'LD1': 1}",Linux/Unix
15260,8,0.307692308,2.666666667,2019-01-25T11:21:42Z,2019-02-19T14:29:12Z,26,23,3,0.115384615,2,5,1,7,{'LD4': 1},1,4,{'LD4': 1},"Brainstorming,Build system,Tests"
15269,1,0.002192982,1,2019-01-26T16:04:50Z,2020-04-26T15:25:32Z,456,455,1,0.002192982,2,1,1,0,{'LD2': 1},1,0,{'LD2': 1},
15271,4,0.010752688,2,2019-01-27T05:31:41Z,2020-02-03T05:29:27Z,372,370,2,0.005376344,1,2,1,3,{'LD1': 1},1,1,{'LD1': 1},"Build system,Questions and Help,Windows"
15286,2,1,1,2019-01-29T19:49:52Z,2019-01-31T18:14:47Z,2,0,2,1,0,2,1,1,{'LD2': 1},1,1,{'LD2': 1},
15289,1,1,1,2019-01-30T03:27:14Z,2019-01-30T13:20:52Z,1,0,1,1,0,1,1,0,{'LD4': 1},1,0,{'LD4': 1},
15290,1,1,1,2019-01-30T10:26:21Z,2019-01-30T12:59:19Z,1,0,1,1,0,1,0,1,{},0,1,{},
15291,12,1.714285714,4,2019-01-30T10:32:09Z,2019-02-05T21:12:21Z,7,4,3,0.428571429,1,3,8,4,"{'LD4': 4, 'LD1': 2, 'LD3': 2}",3,0,"{'LD4': 2, 'LD1': 1, 'LD3': 2}",
15298,1,1,1,2019-01-31T12:32:43Z,2019-01-31T18:00:23Z,1,0,1,1,0,1,0,1,{},0,1,{},
15309,6,0.020134228,3,2019-02-01T03:42:31Z,2019-11-25T19:14:22Z,298,296,2,0.006711409,2,5,1,5,{'LD4': 1},1,4,{'LD4': 1},"RPC/REST/ZMQ,Tests"
15310,4,0.08,1.333333333,2019-02-01T07:21:36Z,2019-03-22T10:10:06Z,50,47,3,0.06,2,3,1,3,{'LD2': 1},1,2,{'LD2': 1},GUI
15311,1,1,1,2019-02-01T07:30:15Z,2019-02-01T08:18:50Z,1,0,1,1,0,1,0,1,{},0,1,{},Resource usage
15312,2,0.010869565,2,2019-02-01T07:45:44Z,2019-08-04T06:04:12Z,184,183,1,0.005434783,2,1,0,2,{},0,1,{},"Linux/Unix,Upstream"
15318,4,0.008908686,1.333333333,2019-02-01T17:38:59Z,2020-04-24T18:57:08Z,449,446,3,0.006681514,1,3,1,3,{'LD1': 1},1,2,{'LD1': 1},Wallet
15319,5,0.011111111,1,2019-02-01T18:11:49Z,2020-04-26T15:32:40Z,450,445,5,0.011111111,4,4,1,4,{'LD2': 1},1,3,{'LD2': 1},"Brainstorming,RPC/REST/ZMQ"
15331,2,0.004454343,2,2019-02-02T23:56:29Z,2020-04-26T15:31:33Z,449,448,1,0.002227171,2,2,0,2,{},0,2,{},
15355,5,0.0625,1.25,2019-02-06T16:28:37Z,2019-04-27T13:30:42Z,80,76,4,0.05,2,3,3,2,"{'LD1': 1, 'LD4': 1, 'LD5': 1}",2,1,"{'LD1': 1, 'LD4': 1, 'LD5': 1}","Mempool,RPC/REST/ZMQ,Wallet"
15361,1,0.2,1,2019-02-07T00:34:58Z,2019-02-11T19:03:01Z,5,4,1,0.2,1,1,1,0,{'LD5': 1},1,0,{'LD5': 1},Wallet
15362,2,2,2,2019-02-07T04:44:48Z,2019-02-07T06:32:38Z,1,0,1,1,0,2,0,2,{},0,2,{},Questions and Help
15366,1,0.5,1,2019-02-07T20:35:13Z,2019-02-09T05:56:31Z,2,1,1,0.5,1,1,0,1,{},0,1,{},Build system
15369,3,0.006726457,1,2019-02-08T08:41:35Z,2020-04-28T12:43:02Z,446,443,3,0.006726457,2,2,1,2,{'LD1': 1},1,1,{'LD1': 1},
15372,1,0.016666667,1,2019-02-08T20:11:43Z,2019-04-09T15:20:16Z,60,59,1,0.016666667,2,1,1,0,{'LD4': 1},1,0,{'LD4': 1},Tests
15379,3,0.6,1.5,2019-02-10T06:37:28Z,2019-02-15T01:59:13Z,5,3,2,0.4,2,3,3,0,"{'LD1': 1, 'LD4': 2}",3,0,"{'LD1': 1, 'LD4': 2}",Linux/Unix
15386,1,1,1,2019-02-12T05:34:56Z,2019-02-13T05:10:30Z,1,0,1,1,0,1,0,1,{},0,1,{},Windows
15392,6,1.2,3,2019-02-12T18:42:47Z,2019-02-16T22:44:25Z,5,3,2,0.4,2,4,1,5,{'LD3': 1},1,3,{'LD3': 1},Wallet
15394,1,1,1,2019-02-12T20:46:31Z,2019-02-12T21:00:44Z,1,0,1,1,0,1,1,0,{'LD2': 1},1,0,{'LD2': 1},
15400,5,0.011389522,1.25,2019-02-13T21:29:13Z,2020-04-27T01:01:36Z,439,435,4,0.009111617,3,3,2,3,"{'LD5': 1, 'LD3': 1}",2,1,"{'LD5': 1, 'LD3': 1}","Tests,macOS"
15403,2,0.00456621,1,2019-02-14T04:06:13Z,2020-04-26T15:34:10Z,438,436,2,0.00456621,3,2,1,1,{'LD4': 1},1,1,{'LD4': 1},Wallet
15409,2,0.018181818,1,2019-02-14T18:18:00Z,2019-06-03T21:21:10Z,110,108,2,0.018181818,2,2,0,2,{},0,2,{},macOS
15417,1,1,1,2019-02-15T13:48:16Z,2019-02-15T16:32:40Z,1,0,1,1,0,1,0,1,{},0,1,{},
15418,4,0.173913043,1,2019-02-15T13:55:55Z,2019-03-09T18:05:40Z,23,19,4,0.173913043,2,1,2,2,"{'LD3': 1, 'LD1': 1}",1,0,"{'LD3': 1, 'LD1': 1}",Linux/Unix
15420,1,1,1,2019-02-15T16:31:21Z,2019-02-15T16:49:41Z,1,0,1,1,0,1,1,0,{'LD4': 1},1,0,{'LD4': 1},
15422,1,0.002293578,1,2019-02-16T13:39:28Z,2020-04-26T15:34:43Z,436,435,1,0.002293578,1,1,1,0,{'LD4': 1},1,0,{'LD4': 1},
15432,3,0.017857143,1.5,2019-02-17T14:28:13Z,2019-08-04T06:00:22Z,168,166,2,0.011904762,2,2,1,2,{'LD4': 1},1,1,{'LD4': 1},
15434,1,0.002141328,1,2019-02-18T09:10:08Z,2020-05-29T10:24:28Z,467,466,1,0.002141328,2,1,1,0,{'LD1': 1},1,0,{'LD1': 1},P2P
15436,2,0.285714286,2,2019-02-18T11:19:15Z,2019-02-25T06:31:31Z,7,6,1,0.142857143,1,2,1,1,{'LD2': 1},1,1,{'LD2': 1},
15438,11,0.080291971,3.666666667,2019-02-19T08:18:12Z,2019-07-05T14:29:35Z,137,134,3,0.02189781,2,3,4,7,"{'LD4': 2, 'LD3': 2}",2,1,"{'LD4': 1, 'LD3': 2}","Feature,Utils/log/libs"
15440,3,0.004366812,1,2019-02-19T12:55:13Z,2021-01-06T12:26:18Z,687,684,3,0.004366812,4,3,0,3,{},0,3,{},"Brainstorming,Build system"
15447,4,0.063492063,1.333333333,2019-02-20T09:40:00Z,2019-04-23T15:01:11Z,63,60,3,0.047619048,2,3,1,3,{'LD1': 1},1,2,{'LD1': 1},"RPC/REST/ZMQ,Resource usage,Wallet"
15449,2,0.057142857,1,2019-02-20T17:21:50Z,2019-03-26T18:20:00Z,35,33,2,0.057142857,2,2,1,1,{'LD1': 1},1,1,{'LD1': 1},Questions and Help
15453,18,0.125874126,2,2019-02-20T22:26:37Z,2019-07-13T15:35:12Z,143,134,9,0.062937063,6,6,11,7,"{'LD3': 6, 'LD2': 3, 'LD4': 1, 'LD6': 1}",5,1,"{'LD3': 4, 'LD2': 2, 'LD4': 1, 'LD6': 1}","Bug,GUI,Wallet"
15455,3,0.428571429,3,2019-02-21T06:32:39Z,2019-02-27T11:02:10Z,7,6,1,0.142857143,1,1,0,3,{},0,1,{},GUI
15460,1,0.166666667,1,2019-02-21T18:55:01Z,2019-02-27T11:06:52Z,6,5,1,0.166666667,1,1,1,0,{'LD4': 1},1,0,{'LD4': 1},"Tests,Windows"
15465,25,0.058139535,2.777777778,2019-02-22T16:43:31Z,2020-04-27T01:00:09Z,430,421,9,0.020930233,5,13,10,15,"{'LD3': 8, 'LD4': 2}",8,5,"{'LD3': 6, 'LD4': 2}","Brainstorming,Docs,Refactoring"
15467,1,0.125,1,2019-02-22T21:58:11Z,2019-03-02T10:07:26Z,8,7,1,0.125,2,1,0,1,{},0,1,{},Windows
15476,3,3,3,2019-02-25T19:14:54Z,2019-02-26T01:13:24Z,1,0,1,1,0,1,2,1,{'LD4': 2},1,0,{'LD4': 1},"Brainstorming,P2P"
15480,1,0.076923077,1,2019-02-25T21:46:23Z,2019-03-10T01:15:33Z,13,12,1,0.076923077,2,1,1,0,{'LD4': 1},1,0,{'LD4': 1},macOS
15484,8,0.013266998,2.666666667,2019-02-26T13:40:27Z,2020-10-20T14:50:49Z,603,600,3,0.004975124,2,4,6,2,"{'LD4': 2, 'LD6': 1, 'LD3': 1, 'LD2': 1, 'LD5': 1}",4,0,"{'LD4': 2, 'LD6': 1, 'LD3': 1, 'LD2': 1, 'LD5': 1}",P2P
15499,1,1,1,2019-02-28T05:16:43Z,2019-02-28T05:29:34Z,1,0,1,1,0,1,1,0,{'LD3': 1},1,0,{'LD3': 1},Questions and Help
15515,2,1,2,2019-03-02T13:42:03Z,2019-03-04T02:53:33Z,2,1,1,0.5,1,2,1,1,{'LD6': 1},1,1,{'LD6': 1},Questions and Help
15523,2,2,2,2019-03-04T14:05:11Z,2019-03-04T22:14:28Z,1,0,1,1,0,2,1,1,{'LD1': 1},1,1,{'LD1': 1},"Build system,macOS"
15525,1,1,1,2019-03-04T15:24:18Z,2019-03-04T16:24:26Z,1,0,1,1,0,1,0,1,{},0,1,{},
15526,4,4,4,2019-03-04T19:03:18Z,2019-03-05T10:19:14Z,1,0,1,1,0,2,3,1,"{'LD4': 1, 'LD2': 1, 'LD5': 1}",2,0,"{'LD4': 1, 'LD2': 1, 'LD5': 1}",RPC/REST/ZMQ
15540,1,1,1,2019-03-05T17:42:37Z,2019-03-05T17:56:42Z,1,0,1,1,0,1,0,1,{},0,1,{},
15541,6,6,6,2019-03-05T23:05:46Z,2019-03-06T17:54:14Z,1,0,1,1,0,1,3,3,"{'LD3': 1, 'LD6': 2}",1,0,"{'LD3': 1, 'LD6': 1}",Build system
15551,2,0.4,1,2019-03-06T20:01:45Z,2019-03-11T16:20:52Z,5,3,2,0.4,2,2,0,2,{},0,2,{},"Upstream,Utils/log/libs"
15555,44,0.771929825,2.315789474,2019-03-07T14:23:25Z,2019-05-03T02:50:23Z,57,38,19,0.333333333,11,14,16,28,"{'LD4': 5, 'LD1': 6, 'LD2': 2, 'LD6': 2, 'LD3': 1}",7,7,"{'LD4': 4, 'LD1': 2, 'LD2': 2, 'LD6': 2, 'LD3': 1}",Tests
15560,24,0.114832536,1.714285714,2019-03-08T11:23:59Z,2019-10-02T17:54:02Z,209,195,14,0.066985646,11,9,9,15,"{'LD3': 1, 'LD6': 2, 'LD2': 4, 'LD4': 2}",7,2,"{'LD3': 1, 'LD6': 2, 'LD2': 3, 'LD4': 2}","Brainstorming,Wallet"
15568,6,0.461538462,1.5,2019-03-09T15:55:37Z,2019-03-21T16:39:22Z,13,9,4,0.307692308,4,4,4,2,"{'LD4': 2, 'LD2': 1, 'LD1': 1}",3,1,"{'LD4': 2, 'LD2': 1, 'LD1': 1}",TX fees and policy
15570,3,0.214285714,1,2019-03-09T22:42:09Z,2019-03-22T22:55:21Z,14,11,3,0.214285714,3,2,2,1,"{'LD4': 1, 'LD5': 1}",1,1,"{'LD4': 1, 'LD5': 1}",Questions and Help
15574,2,0.222222222,2,2019-03-10T18:04:10Z,2019-03-19T05:50:37Z,9,8,1,0.111111111,1,2,1,1,{'LD2': 1},1,1,{'LD2': 1},"Build system,Upstream"
15578,3,0.007281553,3,2019-03-11T16:24:21Z,2020-04-26T15:48:51Z,412,411,1,0.002427184,1,3,1,2,{'LD3': 1},1,2,{'LD3': 1},Scripts and tools
15591,5,0.25,2.5,2019-03-13T12:34:27Z,2019-04-01T19:29:49Z,20,18,2,0.1,3,3,1,4,{'LD4': 1},1,2,{'LD4': 1},Wallet
15592,2,2,2,2019-03-13T13:09:32Z,2019-03-13T15:49:41Z,1,0,1,1,0,2,1,1,{'LD1': 1},1,1,{'LD1': 1},
15593,2,0.133333333,2,2019-03-13T15:28:36Z,2019-03-27T21:15:22Z,15,14,1,0.066666667,2,1,2,0,"{'LD1': 1, 'LD5': 1}",1,0,"{'LD1': 1, 'LD5': 1}",
15599,1,0.015384615,1,2019-03-14T12:33:59Z,2019-05-17T15:06:54Z,65,64,1,0.015384615,2,1,1,0,{'LD4': 1},1,0,{'LD4': 1},"RPC/REST/ZMQ,Wallet"
15619,2,0.086956522,1,2019-03-18T17:58:16Z,2019-04-09T21:54:47Z,23,21,2,0.086956522,2,2,1,1,{'LD3': 1},1,1,{'LD3': 1},"Brainstorming,Refactoring,Validation,Wallet"
15624,4,0.090909091,2,2019-03-20T01:59:01Z,2019-05-02T12:45:59Z,44,42,2,0.045454545,2,1,1,3,{'LD4': 1},1,0,{'LD4': 1},"Linux/Unix,Tests,good first issue"
15630,5,0.02016129,2.5,2019-03-20T20:48:47Z,2019-11-22T21:36:28Z,248,246,2,0.008064516,3,3,0,5,{},0,3,{},"Utils/log/libs,Wallet"
15634,1,0.5,1,2019-03-21T13:22:05Z,2019-03-22T19:16:02Z,2,1,1,0.5,1,1,1,0,{'LD4': 1},1,0,{'LD4': 1},RPC/REST/ZMQ
15636,1,0.002487562,1,2019-03-21T18:56:43Z,2020-04-26T15:49:06Z,402,401,1,0.002487562,1,1,0,1,{},0,1,{},Tests
15648,3,0.032967033,1,2019-03-22T20:18:48Z,2019-06-20T21:40:43Z,91,88,3,0.032967033,3,2,1,2,{'LD6': 1},1,1,{'LD6': 1},"Build system,Tests"
15658,9,0.034220532,3,2019-03-24T14:28:05Z,2019-12-11T23:05:28Z,263,260,3,0.011406844,3,4,1,8,{'LD2': 1},1,3,{'LD2': 1},Build system
15665,2,0.017241379,1,2019-03-25T22:17:57Z,2019-07-19T00:51:37Z,116,114,2,0.017241379,3,1,0,2,{},0,1,{},"P2P,Resource usage"
15667,4,0.055555556,2,2019-03-26T14:32:39Z,2019-06-06T11:13:16Z,72,70,2,0.027777778,1,2,1,3,{'LD4': 1},1,1,{'LD4': 1},GUI
15674,4,0.010075567,1.333333333,2019-03-27T04:03:22Z,2020-04-27T00:57:51Z,397,394,3,0.007556675,2,3,4,0,"{'LD1': 1, 'LD4': 2, 'LD3': 1}",3,0,"{'LD1': 1, 'LD4': 2, 'LD3': 1}","Linux/Unix,Upstream"
15675,1,1,1,2019-03-27T14:08:53Z,2019-03-27T14:40:42Z,1,0,1,1,0,1,1,0,{'LD2': 1},1,0,{'LD2': 1},"Bug,GUI"
15677,5,0.147058824,5,2019-03-27T16:43:40Z,2019-04-29T19:38:59Z,34,33,1,0.029411765,1,2,5,0,"{'LD4': 2, 'LD1': 2, 'LD3': 1}",2,0,"{'LD4': 2, 'LD1': 1, 'LD3': 1}",GUI
15679,2,2,2,2019-03-27T20:23:56Z,2019-03-27T22:54:10Z,1,0,1,1,0,2,1,1,{'LD5': 1},1,1,{'LD5': 1},
15688,3,0.005825243,1.5,2019-03-28T18:02:04Z,2020-08-24T04:14:42Z,515,513,2,0.003883495,2,3,1,2,{'LD6': 1},1,2,{'LD6': 1},Build system
15690,1,0.002747253,1,2019-03-28T20:16:20Z,2020-03-26T18:57:39Z,364,363,1,0.002747253,1,1,0,1,{},0,1,{},Windows
15694,6,0.023076923,1.2,2019-03-29T03:02:27Z,2019-12-13T16:41:26Z,260,255,5,0.019230769,3,2,4,2,"{'LD4': 3, 'LD1': 1}",2,0,"{'LD4': 2, 'LD1': 1}",
15698,1,0.04,1,2019-03-29T18:02:50Z,2019-04-23T17:05:31Z,25,24,1,0.04,1,1,0,1,{},0,1,{},RPC/REST/ZMQ
15702,2,0.133333333,2,2019-03-29T22:35:24Z,2019-04-13T14:12:50Z,15,14,1,0.066666667,2,1,0,2,{},0,1,{},"RPC/REST/ZMQ,Wallet"
15705,1,0.2,1,2019-03-30T13:16:45Z,2019-04-03T13:33:31Z,5,4,1,0.2,2,1,0,1,{},0,1,{},"Docs,RPC/REST/ZMQ"
15708,13,0.03307888,1.857142857,2019-03-31T07:28:42Z,2020-04-26T15:50:09Z,393,386,7,0.017811705,6,7,5,8,"{'LD2': 1, 'LD5': 1, 'LD4': 2, 'LD1': 1}",2,5,"{'LD2': 1, 'LD5': 1, 'LD4': 1, 'LD1': 1}",Linux/Unix
15723,3,0.5,1.5,2019-04-03T05:25:00Z,2019-04-08T22:34:23Z,6,4,2,0.333333333,1,3,0,3,{},0,3,{},
15724,1,0.029411765,1,2019-04-03T05:44:21Z,2019-05-06T11:39:08Z,34,33,1,0.029411765,1,1,0,1,{},0,1,{},"RPC/REST/ZMQ,Wallet"
15725,7,0.017241379,1,2019-04-03T08:24:06Z,2020-05-13T08:15:53Z,406,399,7,0.017241379,5,4,3,4,{'LD3': 3},3,1,{'LD3': 3},"GUI,Wallet"
15733,2,0.333333333,1,2019-04-03T21:04:36Z,2019-04-09T14:49:38Z,6,4,2,0.333333333,1,1,0,2,{},0,1,{},Tests
15734,7,0.012027491,1.4,2019-04-03T21:08:06Z,2020-11-04T22:11:29Z,582,577,5,0.008591065,5,4,2,5,"{'LD3': 1, 'LD2': 1}",2,2,"{'LD3': 1, 'LD2': 1}","Brainstorming,P2P,Wallet"
15736,4,0.010282776,2,2019-04-03T21:51:32Z,2020-04-26T15:51:14Z,389,387,2,0.005141388,2,2,2,2,"{'LD1': 1, 'LD2': 1}",2,0,"{'LD1': 1, 'LD2': 1}","Questions and Help,Wallet"
15737,4,0.571428571,4,2019-04-03T22:14:55Z,2019-04-10T01:21:40Z,7,6,1,0.142857143,1,2,2,2,"{'LD4': 1, 'LD5': 1}",2,0,"{'LD4': 1, 'LD5': 1}","Docs,RPC/REST/ZMQ"
15738,1,0.166666667,1,2019-04-03T22:15:33Z,2019-04-09T15:20:16Z,6,5,1,0.166666667,1,1,0,1,{},0,1,{},Tests
15742,2,0.333333333,1,2019-04-04T01:28:11Z,2019-04-09T12:37:51Z,6,4,2,0.333333333,2,2,2,0,"{'LD3': 1, 'LD2': 1}",2,0,"{'LD3': 1, 'LD2': 1}",RPC/REST/ZMQ
15743,1,0.166666667,1,2019-04-04T01:35:53Z,2019-04-09T12:34:58Z,6,5,1,0.166666667,1,1,0,1,{},0,1,{},RPC/REST/ZMQ
15745,6,0.043478261,1.5,2019-04-04T09:18:18Z,2019-08-19T14:03:47Z,138,134,4,0.028985507,3,4,1,5,{'LD3': 1},1,3,{'LD3': 1},
15781,3,0.007792208,1.5,2019-04-10T09:19:00Z,2020-04-28T12:44:02Z,385,383,2,0.005194805,3,1,0,3,{},0,1,{},Feature
15807,4,0.010526316,1.333333333,2019-04-12T16:02:56Z,2020-04-26T15:52:07Z,380,377,3,0.007894737,2,1,2,2,"{'LD4': 1, 'LD1': 1}",1,0,"{'LD4': 1, 'LD1': 1}","Questions and Help,Wallet"
15808,1,0.111111111,1,2019-04-12T16:13:31Z,2019-04-20T20:21:37Z,9,8,1,0.111111111,2,1,1,0,{'LD1': 1},1,0,{'LD1': 1},RPC/REST/ZMQ
15811,1,0.02173913,1,2019-04-13T10:09:41Z,2019-05-28T20:35:46Z,46,45,1,0.02173913,1,1,0,1,{},0,1,{},
15816,1,0.083333333,1,2019-04-15T01:05:06Z,2019-04-27T00:48:02Z,12,11,1,0.083333333,1,1,0,1,{},0,1,{},"Scripts and tools,good first issue"
15819,2,0.222222222,2,2019-04-15T13:36:22Z,2019-04-24T09:44:11Z,9,8,1,0.111111111,1,2,1,1,{'LD1': 1},1,1,{'LD1': 1},"Upstream,macOS"
15822,5,0.015479876,1.25,2019-04-15T19:03:24Z,2020-03-02T19:43:32Z,323,319,4,0.012383901,5,4,0,5,{},0,4,{},"Build system,GUI,Upstream"
15823,6,0.032432432,2,2019-04-15T19:08:58Z,2019-10-17T14:15:38Z,185,182,3,0.016216216,2,4,2,4,"{'LD4': 1, 'LD3': 1}",2,2,"{'LD4': 1, 'LD3': 1}","Refactoring,Wallet"
15837,2,2,2,2019-04-17T07:48:28Z,2019-04-18T05:24:04Z,1,0,1,1,0,2,1,1,{'LD3': 1},1,1,{'LD3': 1},
15847,58,0.155080214,2.230769231,2019-04-18T20:09:43Z,2020-04-26T15:58:00Z,374,348,26,0.069518717,21,19,13,45,"{'LD2': 1, 'LD1': 2, 'LD3': 4, 'LD6': 1, 'LD5': 2, 'LD4': 3}",9,10,"{'LD2': 1, 'LD1': 2, 'LD3': 4, 'LD6': 1, 'LD5': 2, 'LD4': 3}","Brainstorming,Upstream"
15850,1,1,1,2019-04-19T03:35:09Z,2019-04-19T11:50:58Z,1,0,1,1,0,1,0,1,{},0,1,{},
15857,1,0.076923077,1,2019-04-19T18:53:42Z,2019-05-02T14:31:41Z,13,12,1,0.076923077,1,1,1,0,{'LD4': 1},1,0,{'LD4': 1},"Build system,Upstream"
15859,1,0.5,1,2019-04-20T07:30:57Z,2019-04-22T01:02:00Z,2,1,1,0.5,1,1,1,0,{'LD2': 1},1,0,{'LD2': 1},
15860,2,0.00536193,1,2019-04-20T10:27:50Z,2020-04-26T15:52:49Z,373,371,2,0.00536193,2,2,1,1,{'LD4': 1},1,1,{'LD4': 1},RPC/REST/ZMQ
15865,1,0.5,1,2019-04-21T23:34:30Z,2019-04-23T13:44:58Z,2,1,1,0.5,1,1,0,1,{},0,1,{},Tests
15872,1,1,1,2019-04-23T04:09:36Z,2019-04-23T05:51:35Z,1,0,1,1,0,1,1,0,{'LD1': 1},1,0,{'LD1': 1},
15875,1,1,1,2019-04-23T12:40:04Z,2019-04-24T04:01:53Z,1,0,1,1,0,1,1,0,{'LD2': 1},1,0,{'LD2': 1},
15878,1,0.00990099,1,2019-04-23T17:27:47Z,2019-08-02T12:55:30Z,101,100,1,0.00990099,2,1,0,1,{},0,1,{},"RPC/REST/ZMQ,Wallet"
15879,1,0.5,1,2019-04-23T17:30:56Z,2019-04-25T15:20:18Z,2,1,1,0.5,1,1,1,0,{'LD1': 1},1,0,{'LD1': 1},
15884,4,0.108108108,2,2019-04-24T14:27:11Z,2019-05-31T13:20:29Z,37,35,2,0.054054054,1,1,4,0,"{'LD1': 2, 'LD4': 2}",1,0,"{'LD1': 1, 'LD4': 1}",Wallet
15885,2,0.2,1,2019-04-24T15:56:21Z,2019-05-03T17:54:18Z,10,8,2,0.2,2,2,1,1,{'LD4': 1},1,1,{'LD4': 1},
15889,1,1,1,2019-04-25T08:23:09Z,2019-04-25T12:23:30Z,1,0,1,1,0,1,0,1,{},0,1,{},
15898,1,1,1,2019-04-26T06:23:51Z,2019-04-26T06:38:00Z,1,0,1,1,0,1,1,0,{'LD2': 1},1,0,{'LD2': 1},
15900,5,0.013623978,2.5,2019-04-26T15:06:28Z,2020-04-26T16:00:54Z,367,365,2,0.005449591,1,2,1,4,{'LD5': 1},1,1,{'LD5': 1},
15907,1,0.5,1,2019-04-27T07:03:24Z,2019-04-28T13:29:10Z,2,1,1,0.5,1,1,1,0,{'LD1': 1},1,0,{'LD1': 1},
15912,1,0.5,1,2019-04-27T18:11:05Z,2019-04-29T12:08:59Z,2,1,1,0.5,1,1,0,1,{},0,1,{},Utils/log/libs
15916,2,0.005494505,1,2019-04-28T21:05:15Z,2020-04-26T16:01:16Z,364,362,2,0.005494505,2,1,0,2,{},0,1,{},"Questions and Help,TX fees and policy"
15923,7,0.019283747,2.333333333,2019-04-29T19:01:39Z,2020-04-26T16:03:05Z,363,360,3,0.008264463,2,5,1,6,{'LD1': 1},1,4,{'LD1': 1},"Block storage,Brainstorming"
15924,1,1,1,2019-04-30T00:20:02Z,2019-04-30T00:52:46Z,1,0,1,1,0,1,1,0,{'LD2': 1},1,0,{'LD2': 1},
15925,10,0.026809651,2,2019-04-30T05:59:39Z,2020-05-06T16:25:58Z,373,368,5,0.013404826,4,6,1,9,{'LD3': 1},1,5,{'LD3': 1},"RPC/REST/ZMQ,Resource usage"
15929,9,0.529411765,2.25,2019-05-01T07:38:59Z,2019-05-17T10:21:30Z,17,13,4,0.235294118,4,3,4,5,{'LD6': 4},2,1,{'LD6': 2},P2P
15940,6,0.03125,1.5,2019-05-02T14:05:12Z,2019-11-10T11:31:38Z,192,188,4,0.020833333,5,6,2,4,{'LD3': 2},2,4,{'LD3': 2},good first issue
15944,4,0.043956044,2,2019-05-03T05:58:19Z,2019-08-01T13:18:23Z,91,89,2,0.021978022,1,4,3,1,"{'LD1': 1, 'LD2': 1, 'LD3': 1}",3,1,"{'LD1': 1, 'LD2': 1, 'LD3': 1}","Tests,good first issue"
15951,6,0.461538462,3,2019-05-04T11:24:02Z,2019-05-16T12:35:48Z,13,11,2,0.153846154,2,3,3,3,"{'LD2': 1, 'LD3': 1, 'LD4': 1}",3,0,"{'LD2': 1, 'LD3': 1, 'LD4': 1}",Linux/Unix
15952,2,0.133333333,1,2019-05-04T13:27:59Z,2019-05-18T13:37:33Z,15,13,2,0.133333333,2,2,1,1,{'LD1': 1},1,1,{'LD1': 1},Windows
15958,2,0.1,1,2019-05-06T13:29:08Z,2019-05-25T14:43:40Z,20,18,2,0.1,2,1,1,1,{'LD4': 1},1,0,{'LD4': 1},"Build system,good first issue"
15961,1,0.041666667,1,2019-05-06T15:34:57Z,2019-05-30T01:02:37Z,24,23,1,0.041666667,1,1,1,0,{'LD4': 1},1,0,{'LD4': 1},Utils/log/libs
15967,1,0.090909091,1,2019-05-06T22:28:23Z,2019-05-17T11:25:30Z,11,10,1,0.090909091,1,1,1,0,{'LD3': 1},1,0,{'LD3': 1},
15972,3,1,1.5,2019-05-07T12:30:09Z,2019-05-10T11:16:39Z,3,1,2,0.666666667,1,3,1,2,{'LD5': 1},1,2,{'LD5': 1},GUI
15980,1,0.066666667,1,2019-05-08T08:26:11Z,2019-05-22T12:23:02Z,15,14,1,0.066666667,2,1,0,1,{},0,1,{},Validation
15994,2,0.005494505,1,2019-05-09T19:22:09Z,2020-05-07T12:04:51Z,364,362,2,0.005494505,2,2,2,0,"{'LD5': 1, 'LD3': 1}",2,0,"{'LD5': 1, 'LD3': 1}",
16000,5,0.010799136,1.25,2019-05-09T22:18:24Z,2020-08-14T10:03:16Z,463,459,4,0.008639309,5,4,2,3,{'LD6': 2},2,2,{'LD6': 2},"GUI,good first issue"
16004,9,0.126760563,1.8,2019-05-10T09:26:39Z,2019-07-19T15:21:36Z,71,66,5,0.070422535,5,5,5,4,"{'LD4': 1, 'LD2': 2, 'LD3': 1, 'LD5': 1}",3,2,"{'LD4': 1, 'LD2': 2, 'LD3': 1, 'LD5': 1}","P2P,Resource usage"
16005,1,0.090909091,1,2019-05-10T11:47:41Z,2019-05-20T15:39:10Z,11,10,1,0.090909091,2,1,0,1,{},0,1,{},Resource usage
16007,1,1,1,2019-05-10T13:31:33Z,2019-05-10T14:49:20Z,1,0,1,1,0,1,1,0,{'LD4': 1},1,0,{'LD4': 1},
16008,4,0.011695906,1,2019-05-11T16:42:26Z,2020-04-16T20:47:56Z,342,338,4,0.011695906,3,4,2,2,"{'LD4': 1, 'LD3': 1}",2,2,"{'LD4': 1, 'LD3': 1}",P2P
16009,1,0.5,1,2019-05-11T18:53:39Z,2019-05-13T01:51:35Z,2,1,1,0.5,1,1,1,0,{'LD5': 1},1,0,{'LD5': 1},RPC/REST/ZMQ
16013,2,2,2,2019-05-12T15:15:43Z,2019-05-13T14:16:01Z,1,0,1,1,0,2,1,1,{'LD4': 1},1,1,{'LD4': 1},Docs
16020,3,0.0625,3,2019-05-13T18:14:46Z,2019-06-30T15:27:13Z,48,47,1,0.020833333,2,2,1,2,{'LD3': 1},1,1,{'LD3': 1},Tests
16025,4,0.011494253,2,2019-05-15T01:36:17Z,2020-04-26T16:14:07Z,348,346,2,0.005747126,2,3,3,1,"{'LD4': 2, 'LD1': 1}",3,0,"{'LD4': 2, 'LD1': 1}",Windows
16027,10,0.033670034,1.428571429,2019-05-15T10:43:37Z,2020-03-06T19:52:53Z,297,290,7,0.023569024,5,3,3,7,"{'LD2': 1, 'LD3': 1, 'LD4': 1}",2,1,"{'LD2': 1, 'LD3': 1, 'LD4': 1}",Linux/Unix
16028,2,1,2,2019-05-15T13:15:21Z,2019-05-17T11:20:27Z,2,1,1,0.5,1,1,1,1,{'LD3': 1},1,0,{'LD3': 1},
16031,1,1,1,2019-05-16T03:01:29Z,2019-05-16T14:18:01Z,1,0,1,1,0,1,0,1,{},0,1,{},
16040,1,1,1,2019-05-17T04:05:29Z,2019-05-17T06:28:23Z,1,0,1,1,0,1,0,1,{},0,1,{},RPC/REST/ZMQ
16052,3,0.011450382,1.5,2019-05-20T06:43:07Z,2020-02-05T13:27:43Z,262,260,2,0.007633588,2,3,1,2,{'LD3': 1},1,2,{'LD3': 1},"Build system,macOS"
16054,1,1,1,2019-05-20T08:11:02Z,2019-05-20T10:43:05Z,1,0,1,1,0,1,1,0,{'LD2': 1},1,0,{'LD2': 1},
16055,1,0.166666667,1,2019-05-20T14:11:28Z,2019-05-25T14:43:40Z,6,5,1,0.166666667,1,1,0,1,{},0,1,{},"Build system,Linux/Unix,good first issue"
16058,2,0.014814815,2,2019-05-20T19:06:21Z,2019-10-02T19:03:38Z,135,134,1,0.007407407,2,1,0,2,{},0,1,{},"Brainstorming,P2P"
16061,1,1,1,2019-05-21T07:31:00Z,2019-05-21T07:45:42Z,1,0,1,1,0,1,0,1,{},0,1,{},"Mempool,RPC/REST/ZMQ"
16064,1,0.111111111,1,2019-05-21T11:55:47Z,2019-05-29T12:22:29Z,9,8,1,0.111111111,2,1,0,1,{},0,1,{},"Build system,Scripts and tools"
16072,15,0.033482143,2.5,2019-05-21T22:53:41Z,2020-08-11T19:37:35Z,448,442,6,0.013392857,5,5,5,10,"{'LD2': 1, 'LD6': 1, 'LD4': 2, 'LD1': 1}",3,2,"{'LD2': 1, 'LD6': 1, 'LD4': 2, 'LD1': 1}","Bug,Wallet"
16074,2,0.005865103,1,2019-05-22T10:14:37Z,2020-04-26T16:14:38Z,341,339,2,0.005865103,2,2,1,1,{'LD1': 1},1,1,{'LD1': 1},"Resource usage,Wallet"
16082,1,1,1,2019-05-24T11:54:14Z,2019-05-24T13:16:32Z,1,0,1,1,0,1,0,1,{},0,1,{},
16087,5,0.25,2.5,2019-05-24T22:20:03Z,2019-06-13T08:49:50Z,20,18,2,0.1,3,3,0,5,{},0,3,{},"GUI,macOS"
16091,22,0.065671642,1.833333333,2019-05-26T01:54:32Z,2020-04-24T16:12:17Z,335,323,12,0.035820896,9,9,12,10,"{'LD1': 2, 'LD4': 4, 'LD3': 4, 'LD6': 1, 'LD5': 1}",8,1,"{'LD1': 2, 'LD4': 3, 'LD3': 4, 'LD6': 1, 'LD5': 1}",
16094,4,0.088888889,2,2019-05-26T14:38:10Z,2019-07-10T10:24:49Z,45,43,2,0.044444444,2,2,1,3,{'LD3': 1},1,1,{'LD3': 1},"Build system,Tests,good first issue"
16096,8,0.023738872,1.142857143,2019-05-26T16:41:37Z,2020-04-27T01:07:51Z,337,330,7,0.020771513,7,4,3,5,"{'LD4': 1, 'LD1': 1, 'LD3': 1}",3,1,"{'LD4': 1, 'LD1': 1, 'LD3': 1}","Brainstorming,Tests"
16098,1,0.043478261,1,2019-05-26T21:25:46Z,2019-06-18T16:36:42Z,23,22,1,0.043478261,2,1,0,1,{},0,1,{},Utils/log/libs
16100,5,5,5,2019-05-27T10:51:48Z,2019-05-27T15:35:41Z,1,0,1,1,0,2,1,4,{'LD4': 1},1,1,{'LD4': 1},
16101,1,0.5,1,2019-05-27T13:57:01Z,2019-05-29T07:03:52Z,2,1,1,0.5,1,1,1,0,{'LD2': 1},1,0,{'LD2': 1},GUI
16108,1,1,1,2019-05-27T21:15:24Z,2019-05-27T22:02:03Z,1,0,1,1,0,1,1,0,{'LD2': 1},1,0,{'LD2': 1},
16111,2,2,2,2019-05-28T12:05:40Z,2019-05-29T02:40:10Z,1,0,1,1,0,1,1,1,{'LD4': 1},1,0,{'LD4': 1},Wallet
16121,1,0.333333333,1,2019-05-29T21:13:41Z,2019-06-01T17:51:32Z,3,2,1,0.333333333,1,1,0,1,{},0,1,{},Tests
16125,4,0.00913242,2,2019-05-30T11:06:38Z,2020-08-10T07:20:12Z,438,436,2,0.00456621,3,4,1,3,{'LD2': 1},1,3,{'LD2': 1},"GUI,macOS"
16132,1,1,1,2019-06-01T17:50:43Z,2019-06-01T18:02:02Z,1,0,1,1,0,1,1,0,{'LD2': 1},1,0,{'LD2': 1},
16133,2,0.006097561,1,2019-06-01T19:22:38Z,2020-04-24T16:48:39Z,328,326,2,0.006097561,2,1,1,1,{'LD4': 1},1,0,{'LD4': 1},P2P
16137,4,0.011396011,1,2019-06-03T11:47:15Z,2020-05-19T11:27:23Z,351,347,4,0.011396011,4,2,0,4,{},0,2,{},"Build system,GUI,Upstream"
16142,14,1,7,2019-06-03T23:35:07Z,2019-06-17T14:19:30Z,14,12,2,0.142857143,1,4,9,5,{'LD1': 9},2,2,{'LD1': 2},"Docs,RPC/REST/ZMQ,good first issue"
16148,18,0.127659574,1.636363636,2019-06-05T11:15:56Z,2019-10-23T21:14:18Z,141,130,11,0.078014184,7,8,4,14,"{'LD1': 1, 'LD6': 2, 'LD4': 1}",4,4,"{'LD1': 1, 'LD6': 2, 'LD4': 1}","Brainstorming,Tests"
16150,3,0.0625,1,2019-06-05T14:56:15Z,2019-07-23T07:10:18Z,48,45,3,0.0625,3,1,1,2,{'LD6': 1},1,0,{'LD6': 1},Build system
16154,1,0.004098361,1,2019-06-05T17:54:05Z,2020-02-04T02:19:00Z,244,243,1,0.004098361,2,1,1,0,{'LD4': 1},1,0,{'LD4': 1},GUI
16160,8,0.024615385,1.333333333,2019-06-06T19:24:48Z,2020-04-26T16:15:09Z,325,319,6,0.018461538,4,3,5,3,"{'LD4': 1, 'LD1': 3, 'LD3': 1}",2,1,"{'LD4': 1, 'LD1': 2, 'LD3': 1}",Wallet
16165,9,0.02425876,1.285714286,2019-06-07T11:41:51Z,2020-06-12T05:37:03Z,371,364,7,0.018867925,5,7,6,3,"{'LD4': 1, 'LD3': 5}",5,2,"{'LD4': 1, 'LD3': 5}","Brainstorming,Wallet"
16178,2,0.007042254,1,2019-06-09T23:09:14Z,2020-03-19T18:23:49Z,284,282,2,0.007042254,1,2,1,1,{'LD4': 1},1,1,{'LD4': 1},"Questions and Help,Wallet"
16179,2,0.4,1,2019-06-09T23:22:46Z,2019-06-14T09:41:34Z,5,3,2,0.4,2,2,1,1,{'LD5': 1},1,1,{'LD5': 1},Questions and Help
16181,12,0.141176471,12,2019-06-10T07:13:41Z,2019-09-02T11:32:18Z,85,84,1,0.011764706,1,5,3,9,"{'LD4': 1, 'LD3': 1, 'LD1': 1}",3,2,"{'LD4': 1, 'LD3': 1, 'LD1': 1}","Brainstorming,RPC/REST/ZMQ,Wallet,good first issue"
16182,3,0.008982036,1.5,2019-06-10T09:56:43Z,2020-05-08T23:33:33Z,334,332,2,0.005988024,2,3,0,3,{},0,3,{},"Brainstorming,UTXO Db and Indexes"
16193,2,1,2,2019-06-12T13:08:05Z,2019-06-13T13:23:22Z,2,1,1,0.5,1,2,1,1,{'LD4': 1},1,1,{'LD4': 1},
16200,5,0.416666667,2.5,2019-06-13T08:16:03Z,2019-06-24T19:11:02Z,12,10,2,0.166666667,2,3,3,2,{'LD3': 3},2,1,{'LD3': 2},"Feature,Scripts and tools"
16203,9,0.080357143,3,2019-06-13T13:31:04Z,2019-10-02T14:06:04Z,112,109,3,0.026785714,4,4,4,5,{'LD6': 4},2,2,{'LD6': 2},"RPC/REST/ZMQ,good first issue"
16209,1,1,1,2019-06-14T02:04:39Z,2019-06-14T17:24:11Z,1,0,1,1,0,1,0,1,{},0,1,{},Questions and Help
16211,3,1,1.5,2019-06-14T05:58:29Z,2019-06-16T13:42:31Z,3,1,2,0.666666667,1,3,1,2,{'LD4': 1},1,2,{'LD4': 1},"Build system,good first issue"
16216,3,0.009090909,1.5,2019-06-14T17:27:52Z,2020-05-08T23:19:55Z,330,328,2,0.006060606,2,3,2,1,"{'LD3': 1, 'LD5': 1}",2,1,"{'LD3': 1, 'LD5': 1}",Feature
16218,3,0.008287293,1,2019-06-15T10:15:54Z,2020-06-10T13:52:57Z,362,359,3,0.008287293,4,1,0,3,{},0,1,{},"GUI,Utils/log/libs,good first issue"
16230,1,0.166666667,1,2019-06-18T10:10:00Z,2019-06-23T10:58:47Z,6,5,1,0.166666667,1,1,0,1,{},0,1,{},GUI
16242,2,0.006389776,2,2019-06-19T09:39:57Z,2020-04-26T16:17:46Z,313,312,1,0.003194888,1,2,1,1,{'LD4': 1},1,1,{'LD4': 1},RPC/REST/ZMQ
16266,3,0.013157895,3,2019-06-21T20:21:28Z,2020-02-04T02:20:58Z,228,227,1,0.004385965,1,1,2,1,{'LD3': 2},1,0,{'LD3': 1},"GUI,Upstream"
16268,4,0.222222222,1,2019-06-22T15:31:17Z,2019-07-09T23:41:34Z,18,14,4,0.222222222,3,3,3,1,"{'LD4': 1, 'LD3': 2}",2,1,"{'LD4': 1, 'LD3': 1}",Questions and Help
16274,2,2,2,2019-06-24T04:15:26Z,2019-06-24T17:13:31Z,1,0,1,1,0,2,2,0,{'LD1': 2},2,0,{'LD1': 2},
16275,3,1.5,1.5,2019-06-24T09:29:45Z,2019-06-25T15:55:12Z,2,0,2,1,0,2,2,1,{'LD4': 2},2,0,{'LD4': 2},"Questions and Help,RPC/REST/ZMQ"
16280,3,0.031914894,1.5,2019-06-25T00:46:11Z,2019-09-26T11:30:45Z,94,92,2,0.021276596,2,2,1,2,{'LD4': 1},1,1,{'LD4': 1},"Scripts and tools,good first issue"
16288,2,2,2,2019-06-26T03:47:20Z,2019-06-26T22:33:42Z,1,0,1,1,0,2,0,2,{},0,2,{},Tests
16296,10,0.081967213,2.5,2019-06-27T07:30:25Z,2019-10-26T11:00:28Z,122,118,4,0.032786885,3,3,2,8,{'LD3': 2},2,1,{'LD3': 2},"Bug,GUI,macOS"
16304,1,0.00330033,1,2019-06-28T16:37:24Z,2020-04-26T16:18:19Z,303,302,1,0.00330033,1,1,0,1,{},0,1,{},Questions and Help
16306,2,0.00660066,1,2019-06-29T05:01:13Z,2020-04-26T16:19:25Z,303,301,2,0.00660066,3,2,2,0,"{'LD2': 1, 'LD4': 1}",2,0,"{'LD2': 1, 'LD4': 1}",GUI
16307,16,0.05734767,2.285714286,2019-06-29T05:16:34Z,2020-04-02T23:42:17Z,279,272,7,0.025089606,5,5,7,9,"{'LD1': 1, 'LD3': 3, 'LD4': 1, 'LD6': 1, 'LD5': 1}",2,3,"{'LD1': 1, 'LD3': 2, 'LD4': 1, 'LD6': 1, 'LD5': 1}",
16315,1,0.027777778,1,2019-06-29T16:12:27Z,2019-08-04T05:54:20Z,36,35,1,0.027777778,2,1,0,1,{},0,1,{},
16318,5,0.054347826,1,2019-06-30T14:43:48Z,2019-09-30T12:36:44Z,92,87,5,0.054347826,3,5,2,3,"{'LD4': 1, 'LD3': 1}",2,3,"{'LD4': 1, 'LD3': 1}","Brainstorming,GUI"
16321,1,0.00591716,1,2019-07-01T12:39:46Z,2019-12-17T10:17:41Z,169,168,1,0.00591716,2,1,1,0,{'LD4': 1},1,0,{'LD4': 1},P2P
16335,5,5,5,2019-07-04T00:37:41Z,2019-07-04T02:00:07Z,1,0,1,1,0,2,2,3,"{'LD1': 1, 'LD4': 1}",1,1,"{'LD1': 1, 'LD4': 1}",Questions and Help
16340,1,1,1,2019-07-05T02:19:53Z,2019-07-05T02:41:02Z,1,0,1,1,0,1,1,0,{'LD2': 1},1,0,{'LD2': 1},Tests
16343,9,0.03030303,2.25,2019-07-05T06:02:06Z,2020-04-27T01:06:21Z,297,293,4,0.013468013,4,4,0,9,{},0,4,{},
16346,3,0.010204082,1,2019-07-05T20:10:35Z,2020-04-24T18:26:26Z,294,291,3,0.010204082,4,3,1,2,{'LD1': 1},1,2,{'LD1': 1},"Docs,good first issue"
16353,7,0.023809524,2.333333333,2019-07-08T10:36:30Z,2020-04-26T17:09:45Z,294,291,3,0.010204082,3,2,1,6,{'LD4': 1},1,1,{'LD4': 1},RPC/REST/ZMQ
16369,2,0.083333333,2,2019-07-10T21:45:37Z,2019-08-03T19:29:00Z,24,23,1,0.041666667,2,1,1,1,{'LD4': 1},1,0,{'LD4': 1},
16372,4,0.166666667,1.333333333,2019-07-11T09:16:33Z,2019-08-04T05:53:25Z,24,21,3,0.125,3,2,3,1,"{'LD4': 1, 'LD1': 1, 'LD5': 1}",2,0,"{'LD4': 1, 'LD1': 1, 'LD5': 1}",RPC/REST/ZMQ
16376,4,0.571428571,1.333333333,2019-07-12T00:54:31Z,2019-07-18T11:59:37Z,7,4,3,0.428571429,2,2,2,2,"{'LD1': 1, 'LD3': 1}",1,1,"{'LD1': 1, 'LD3': 1}",Linux/Unix
16382,4,0.059701493,1.333333333,2019-07-13T15:12:56Z,2019-09-18T14:49:31Z,67,64,3,0.044776119,2,3,2,2,{'LD4': 2},2,1,{'LD4': 2},"Bug,RPC/REST/ZMQ,TX fees and policy,good first issue"
16387,6,0.048780488,1.5,2019-07-14T12:04:42Z,2019-11-14T10:10:27Z,123,119,4,0.032520325,5,5,1,5,{'LD2': 1},1,4,{'LD2': 1},"Bug,Upstream,macOS"
16388,4,4,4,2019-07-14T19:17:31Z,2019-07-15T12:06:39Z,1,0,1,1,0,4,2,2,"{'LD1': 1, 'LD2': 1}",2,2,"{'LD1': 1, 'LD2': 1}",Questions and Help
16393,6,1.2,3,2019-07-15T14:39:07Z,2019-07-19T21:49:03Z,5,3,2,0.4,1,3,2,4,"{'LD3': 1, 'LD6': 1}",2,1,"{'LD3': 1, 'LD6': 1}","Brainstorming,Wallet"
16395,1,0.003496503,1,2019-07-16T13:07:56Z,2020-04-27T01:32:18Z,286,285,1,0.003496503,1,1,0,1,{},0,1,{},Tests
16396,2,0.025974026,2,2019-07-16T14:15:14Z,2019-09-30T20:12:39Z,77,76,1,0.012987013,1,2,0,2,{},0,2,{},RPC/REST/ZMQ
16403,5,0.016611296,1.25,2019-07-17T01:51:03Z,2020-05-12T02:36:47Z,301,297,4,0.013289037,3,3,0,5,{},0,3,{},"Brainstorming,macOS"
16407,6,0.018927445,6,2019-07-17T18:33:40Z,2020-05-29T06:55:37Z,317,316,1,0.003154574,1,5,4,2,{'LD3': 4},4,1,{'LD3': 4},"Brainstorming,GUI"
16423,4,0.022099448,2,2019-07-19T09:42:10Z,2020-01-15T16:35:20Z,181,179,2,0.011049724,2,1,3,1,"{'LD4': 1, 'LD3': 1, 'LD5': 1}",1,0,"{'LD4': 1, 'LD3': 1, 'LD5': 1}","GUI,Linux/Unix"
16427,1,1,1,2019-07-20T13:05:06Z,2019-07-20T16:00:31Z,1,0,1,1,0,1,1,0,{'LD1': 1},1,0,{'LD1': 1},Docs
16447,1,0.045454545,1,2019-07-24T06:06:52Z,2019-08-14T10:21:39Z,22,21,1,0.045454545,2,1,0,1,{},0,1,{},Build system
16454,1,1,1,2019-07-24T20:32:28Z,2019-07-24T21:21:59Z,1,0,1,1,0,1,1,0,{'LD5': 1},1,0,{'LD5': 1},
16456,3,0.6,1.5,2019-07-25T03:14:49Z,2019-07-29T12:34:50Z,5,3,2,0.4,2,2,1,2,{'LD4': 1},1,1,{'LD4': 1},Questions and Help
16472,18,1.5,3.6,2019-07-26T20:50:49Z,2019-08-07T11:23:43Z,12,7,5,0.416666667,1,9,8,10,"{'LD2': 3, 'LD4': 3, 'LD3': 2}",6,3,"{'LD2': 3, 'LD4': 3, 'LD3': 1}",Brainstorming
16473,2,0.666666667,2,2019-07-26T21:04:29Z,2019-07-29T08:21:07Z,3,2,1,0.333333333,1,2,1,1,{'LD1': 1},1,1,{'LD1': 1},Linux/Unix
16478,6,0.857142857,3,2019-07-28T13:55:42Z,2019-08-04T05:49:47Z,7,5,2,0.285714286,1,2,3,3,"{'LD4': 2, 'LD3': 1}",2,0,"{'LD4': 1, 'LD3': 1}",macOS
16479,1,1,1,2019-07-28T18:29:52Z,2019-07-28T21:48:53Z,1,0,1,1,0,1,1,0,{'LD1': 1},1,0,{'LD1': 1},
16482,2,1,1,2019-07-29T03:12:01Z,2019-07-30T06:29:53Z,2,0,2,1,0,2,0,2,{},0,2,{},
16485,6,0.090909091,1.2,2019-07-29T13:46:12Z,2019-10-02T15:06:10Z,66,61,5,0.075757576,4,2,1,5,{'LD2': 1},1,1,{'LD2': 1},"RPC/REST/ZMQ,Wallet"
16488,3,0.75,1.5,2019-07-29T18:02:14Z,2019-08-02T12:19:47Z,4,2,2,0.5,1,1,0,3,{},0,1,{},Tests
16496,8,0.014234875,1.6,2019-07-30T17:50:25Z,2021-02-10T22:54:06Z,562,557,5,0.008896797,5,5,3,5,"{'LD6': 1, 'LD4': 2}",3,2,"{'LD6': 1, 'LD4': 2}","Brainstorming,Build system"
16537,1,0.333333333,1,2019-08-02T19:24:17Z,2019-08-05T11:51:26Z,3,2,1,0.333333333,1,1,1,0,{'LD3': 1},1,0,{'LD3': 1},Tests
16550,18,4.5,6,2019-08-05T21:53:01Z,2019-08-09T11:46:12Z,4,1,3,0.75,1,5,6,12,"{'LD3': 2, 'LD1': 2, 'LD4': 2}",3,2,"{'LD3': 2, 'LD1': 2, 'LD4': 1}","Build system,Linux/Unix"
16553,1,1,1,2019-08-06T06:59:24Z,2019-08-06T21:55:42Z,1,0,1,1,0,1,0,1,{},0,1,{},Upstream
16565,2,0.007604563,1,2019-08-07T22:02:07Z,2020-04-26T17:11:53Z,263,261,2,0.007604563,2,2,2,0,"{'LD3': 1, 'LD1': 1}",2,0,"{'LD3': 1, 'LD1': 1}",
16567,1,1,1,2019-08-08T05:37:06Z,2019-08-08T06:00:32Z,1,0,1,1,0,1,1,0,{'LD1': 1},1,0,{'LD1': 1},
16568,9,0.017751479,1.5,2019-08-08T08:58:24Z,2020-12-27T03:20:53Z,507,501,6,0.01183432,6,5,2,7,"{'LD4': 1, 'LD1': 1}",2,3,"{'LD4': 1, 'LD1': 1}","Android,Build system"
16575,9,0.034351145,3,2019-08-09T14:22:45Z,2020-04-27T01:11:03Z,262,259,3,0.011450382,4,2,3,6,"{'LD2': 2, 'LD6': 1}",1,1,"{'LD2': 1, 'LD6': 1}",Windows
16576,8,0.131147541,1.6,2019-08-09T15:06:30Z,2019-10-09T14:31:13Z,61,56,5,0.081967213,4,3,4,4,"{'LD4': 2, 'LD6': 1, 'LD3': 1}",3,0,"{'LD4': 2, 'LD6': 1, 'LD3': 1}","Docs,Tests"
16579,4,1.333333333,4,2019-08-10T02:25:41Z,2019-08-12T08:29:43Z,3,2,1,0.333333333,1,2,1,3,{'LD1': 1},1,1,{'LD1': 1},GUI
16588,4,0.015384615,1.333333333,2019-08-12T19:14:06Z,2020-04-28T08:44:29Z,260,257,3,0.011538462,3,3,1,3,{'LD4': 1},1,2,{'LD4': 1},Build system
16591,1,0.058823529,1,2019-08-12T20:14:10Z,2019-08-29T14:28:54Z,17,16,1,0.058823529,2,1,0,1,{},0,1,{},GUI
16594,5,2.5,5,2019-08-13T12:07:47Z,2019-08-14T12:14:06Z,2,1,1,0.5,1,3,2,3,{'LD4': 2},2,1,{'LD4': 2},"Bug,Docs,good first issue"
16600,1,1,1,2019-08-13T22:20:16Z,2019-08-13T23:11:51Z,1,0,1,1,0,1,1,0,{'LD4': 1},1,0,{'LD4': 1},GUI
16602,1,1,1,2019-08-14T04:34:24Z,2019-08-14T04:42:34Z,1,0,1,1,0,1,1,0,{'LD1': 1},1,0,{'LD1': 1},
16613,10,0.019569472,1.428571429,2019-08-14T14:47:58Z,2021-01-06T12:26:48Z,511,504,7,0.01369863,6,4,4,6,"{'LD2': 1, 'LD3': 2, 'LD4': 1}",4,0,"{'LD2': 1, 'LD3': 2, 'LD4': 1}",Tests
16627,3,0.12,3,2019-08-16T02:25:30Z,2019-09-09T10:56:17Z,25,24,1,0.04,1,2,2,1,{'LD3': 2},2,0,{'LD3': 2},Docs
16632,5,0.044247788,1.25,2019-08-16T10:59:02Z,2019-12-06T14:27:49Z,113,109,4,0.03539823,4,5,2,3,"{'LD1': 1, 'LD4': 1}",2,3,"{'LD1': 1, 'LD4': 1}","Build system,macOS"
16637,3,0.333333333,1.5,2019-08-16T20:29:18Z,2019-08-25T16:22:09Z,9,7,2,0.222222222,1,2,2,1,"{'LD4': 1, 'LD3': 1}",1,1,"{'LD4': 1, 'LD3': 1}",Linux/Unix
16642,9,0.9,3,2019-08-17T23:24:46Z,2019-08-27T04:53:49Z,10,7,3,0.3,3,3,3,6,"{'LD4': 2, 'LD1': 1}",2,1,"{'LD4': 2, 'LD1': 1}",P2P
16660,4,0.013422819,1.333333333,2019-08-19T20:14:19Z,2020-06-12T18:50:22Z,298,295,3,0.010067114,4,3,3,1,"{'LD5': 2, 'LD6': 1}",3,0,"{'LD5': 2, 'LD6': 1}","P2P,Tests"
16668,4,0.363636364,2,2019-08-20T10:39:30Z,2019-08-31T01:18:00Z,11,9,2,0.181818182,2,2,1,3,{'LD2': 1},1,1,{'LD2': 1},"Wallet,good first issue"
16672,2,0.008,1,2019-08-20T20:08:16Z,2020-04-26T17:11:25Z,250,248,2,0.008,3,1,1,1,{'LD2': 1},1,0,{'LD2': 1},Windows
16676,2,0.4,1,2019-08-22T00:27:17Z,2019-08-26T20:53:14Z,5,3,2,0.4,1,1,0,2,{},0,1,{},
16683,4,0.011049724,2,2019-08-22T16:00:40Z,2020-08-17T22:25:57Z,362,360,2,0.005524862,2,3,3,1,"{'LD3': 1, 'LD4': 1, 'LD5': 1}",2,1,"{'LD3': 1, 'LD4': 1, 'LD5': 1}","Brainstorming,P2P"
16684,32,0.070175439,1.777777778,2019-08-22T20:01:53Z,2020-11-20T15:59:32Z,456,438,18,0.039473684,14,11,9,23,"{'LD4': 4, 'LD3': 1, 'LD1': 1, 'LD2': 2, 'LD5': 1}",4,7,"{'LD4': 3, 'LD3': 1, 'LD1': 1, 'LD2': 2, 'LD5': 1}",Brainstorming
16685,4,0.020725389,2,2019-08-22T20:24:28Z,2020-03-02T05:03:30Z,193,191,2,0.010362694,2,3,1,3,{'LD4': 1},1,2,{'LD4': 1},"Android,Upstream"
16693,5,0.012285012,1.666666667,2019-08-23T09:54:03Z,2020-10-02T11:37:58Z,407,404,3,0.007371007,3,4,1,4,{'LD3': 1},1,3,{'LD3': 1},P2P
16697,15,0.087209302,2.5,2019-08-23T15:40:07Z,2020-02-10T16:35:46Z,172,166,6,0.034883721,5,5,1,14,{'LD4': 1},1,4,{'LD4': 1},"Bug,Validation"
16699,1,1,1,2019-08-23T17:25:27Z,2019-08-23T19:12:31Z,1,0,1,1,0,1,1,0,{'LD4': 1},1,0,{'LD4': 1},
16700,1,0.005464481,1,2019-08-23T18:06:23Z,2020-02-21T23:03:30Z,183,182,1,0.005464481,1,1,0,1,{},0,1,{},Tests
16719,4,0.571428571,2,2019-08-25T09:10:25Z,2019-08-31T10:55:31Z,7,5,2,0.285714286,2,3,0,4,{},0,3,{},"Brainstorming,RPC/REST/ZMQ"
16734,6,0.028436019,1.5,2019-08-27T17:09:31Z,2020-03-25T13:48:57Z,211,207,4,0.018957346,5,3,1,5,{'LD3': 1},1,2,{'LD3': 1},Build system
16736,2,1,1,2019-08-27T18:27:08Z,2019-08-28T20:17:06Z,2,0,2,1,0,2,1,1,{'LD2': 1},1,1,{'LD2': 1},Windows
16741,3,0.012345679,1,2019-08-28T14:51:48Z,2020-04-26T15:50:28Z,243,240,3,0.012345679,2,1,1,2,{'LD4': 1},1,0,{'LD4': 1},Tests
16744,1,0.142857143,1,2019-08-28T18:55:54Z,2019-09-04T17:15:39Z,7,6,1,0.142857143,1,1,0,1,{},0,1,{},"Tests,good first issue"
16749,1,1,1,2019-08-28T21:36:20Z,2019-08-28T21:41:31Z,1,0,1,1,0,1,0,1,{},0,1,{},
16751,6,0.023346304,1.2,2019-08-29T09:10:55Z,2020-05-11T23:44:52Z,257,252,5,0.019455253,5,4,3,3,{'LD1': 3},2,2,{'LD1': 2},"Android,Linux/Unix"
16754,9,9,9,2019-08-29T11:41:06Z,2019-08-30T00:38:16Z,1,0,1,1,0,5,4,5,"{'LD6': 2, 'LD3': 1, 'LD1': 1}",3,2,"{'LD6': 2, 'LD3': 1, 'LD1': 1}",GUI
16763,1,0.25,1,2019-08-30T07:04:53Z,2019-09-03T01:48:01Z,4,3,1,0.25,1,1,0,1,{},0,1,{},
16773,1,0.25,1,2019-08-31T18:18:45Z,2019-09-03T20:40:18Z,4,3,1,0.25,1,1,0,1,{},0,1,{},"Bug,Utils/log/libs"
16775,2,0.666666667,2,2019-08-31T22:27:07Z,2019-09-03T14:58:59Z,3,2,1,0.333333333,1,1,1,1,{'LD4': 1},1,0,{'LD4': 1},
16776,12,0.055813953,2,2019-09-01T01:43:18Z,2020-04-02T13:08:09Z,215,209,6,0.027906977,6,7,3,9,{'LD4': 3},3,4,{'LD4': 3},"Wallet,good first issue"
16777,1,1,1,2019-09-01T05:54:30Z,2019-09-01T19:26:32Z,1,0,1,1,0,1,0,1,{},0,1,{},
16780,1,0.111111111,1,2019-09-01T11:06:43Z,2019-09-10T07:04:18Z,9,8,1,0.111111111,1,1,0,1,{},0,1,{},"P2P,RPC/REST/ZMQ"
16794,1,0.066666667,1,2019-09-03T15:50:12Z,2019-09-17T17:38:28Z,15,14,1,0.066666667,1,1,0,1,{},0,1,{},Tests
16803,1,0.058823529,1,2019-09-04T08:51:45Z,2019-09-21T02:01:09Z,17,16,1,0.058823529,2,1,1,0,{'LD6': 1},1,0,{'LD6': 1},"Build system,Upstream"
16813,2,0.008547009,1,2019-09-05T23:50:38Z,2020-04-26T17:12:49Z,234,232,2,0.008547009,2,2,1,1,{'LD4': 1},1,1,{'LD4': 1},"Brainstorming,Docs"
16814,4,0.153846154,2,2019-09-05T23:59:58Z,2019-10-01T08:56:09Z,26,24,2,0.076923077,2,4,1,3,{'LD1': 1},1,3,{'LD1': 1},"GUI,Scripts and tools"
16816,4,0.057142857,4,2019-09-06T05:46:36Z,2019-11-15T03:30:15Z,70,69,1,0.014285714,1,4,3,1,{'LD4': 3},3,1,{'LD4': 3},
16820,9,0.9,9,2019-09-07T06:58:46Z,2019-09-16T08:53:02Z,10,9,1,0.1,1,2,1,8,{'LD6': 1},1,1,{'LD6': 1},"GUI,good first issue"
16824,9,0.038461538,2.25,2019-09-07T17:24:59Z,2020-04-28T12:45:48Z,234,230,4,0.017094017,5,5,2,7,{'LD4': 2},2,3,{'LD4': 2},
16832,2,2,2,2019-09-08T16:18:48Z,2019-09-08T19:58:33Z,1,0,1,1,0,2,1,1,{'LD4': 1},1,1,{'LD4': 1},
16840,5,0.010989011,5,2019-09-10T00:18:53Z,2020-12-07T12:01:57Z,455,454,1,0.002197802,1,3,1,4,{'LD4': 1},1,2,{'LD4': 1},"Bug,TX fees and policy"
16846,3,0.2,1.5,2019-09-10T16:15:21Z,2019-09-24T20:34:50Z,15,13,2,0.133333333,2,1,3,0,"{'LD4': 2, 'LD1': 1}",1,0,"{'LD4': 1, 'LD1': 1}",Docs
16862,5,5,5,2019-09-13T13:53:32Z,2019-09-13T17:39:46Z,1,0,1,1,0,2,2,3,"{'LD2': 1, 'LD1': 1}",1,1,"{'LD2': 1, 'LD1': 1}",Feature
16886,4,0.017777778,1,2019-09-16T16:31:36Z,2020-04-28T15:09:33Z,225,221,4,0.017777778,3,2,2,2,"{'LD3': 1, 'LD5': 1}",1,1,"{'LD3': 1, 'LD5': 1}",P2P
16891,5,0.227272727,2.5,2019-09-17T04:12:04Z,2019-10-08T12:08:27Z,22,20,2,0.090909091,2,2,1,4,{'LD3': 1},1,1,{'LD3': 1},"Build system,good first issue"
16894,2,0.083333333,2,2019-09-17T10:19:51Z,2019-10-10T17:21:11Z,24,23,1,0.041666667,1,2,0,2,{},0,2,{},"Bug,Tests,Windows,good first issue"
16904,3,0.013513514,1.5,2019-09-18T12:47:56Z,2020-04-26T17:16:54Z,222,220,2,0.009009009,1,2,2,1,"{'LD3': 1, 'LD2': 1}",2,0,"{'LD3': 1, 'LD2': 1}","Bug,Linux/Unix,Upstream"
16909,1,0.037037037,1,2019-09-18T21:06:19Z,2019-10-15T21:04:07Z,27,26,1,0.037037037,2,1,1,0,{'LD3': 1},1,0,{'LD3': 1},"Bug,macOS"
16919,2,0.009174312,1,2019-09-19T19:31:46Z,2020-04-24T17:02:31Z,218,216,2,0.009174312,3,2,0,2,{},0,2,{},"Brainstorming,P2P"
16924,2,0.4,2,2019-09-20T17:37:14Z,2019-09-25T14:21:54Z,5,4,1,0.2,1,2,0,2,{},0,2,{},"Brainstorming,GUI"
16925,2,0.2,1,2019-09-20T17:41:39Z,2019-09-30T09:32:58Z,10,8,2,0.2,2,1,0,2,{},0,1,{},"Bug,Build system"
16933,1,0.004587156,1,2019-09-22T02:44:01Z,2020-04-26T17:17:44Z,218,217,1,0.004587156,1,1,0,1,{},0,1,{},Wallet
16937,1,0.009259259,1,2019-09-22T23:59:54Z,2020-01-08T14:58:45Z,108,107,1,0.009259259,2,1,1,0,{'LD4': 1},1,0,{'LD4': 1},"GUI,good first issue"
16954,3,0.009230769,1,2019-09-24T13:33:26Z,2020-08-14T10:04:38Z,325,322,3,0.009230769,3,3,1,2,{'LD2': 1},1,2,{'LD2': 1},"Brainstorming,Feature,GUI"
16958,3,3,3,2019-09-24T19:15:30Z,2019-09-24T19:56:43Z,1,0,1,1,0,1,1,2,{'LD4': 1},1,0,{'LD4': 1},Bug
16976,1,0.005128205,1,2019-09-27T15:05:20Z,2020-04-09T12:09:43Z,195,194,1,0.005128205,2,1,0,1,{},0,1,{},"Tests,Windows,good first issue"
16977,1,0.004694836,1,2019-09-27T16:01:59Z,2020-04-26T22:42:38Z,213,212,1,0.004694836,1,1,0,1,{},0,1,{},"Brainstorming,P2P"
16979,6,0.021505376,1.5,2019-09-28T12:55:27Z,2020-07-03T04:57:12Z,279,275,4,0.014336918,3,2,4,2,"{'LD1': 3, 'LD3': 1}",2,0,"{'LD1': 2, 'LD3': 1}","RPC/REST/ZMQ,Resource usage"
16980,6,0.052631579,3,2019-09-28T18:56:17Z,2020-01-20T16:09:35Z,114,112,2,0.01754386,2,4,4,2,"{'LD4': 3, 'LD1': 1}",4,0,"{'LD4': 3, 'LD1': 1}","Brainstorming,Feature"
16985,6,0.047244094,2,2019-09-29T20:05:03Z,2020-02-03T05:31:49Z,127,124,3,0.023622047,1,4,2,4,"{'LD1': 1, 'LD3': 1}",1,3,"{'LD1': 1, 'LD3': 1}","Brainstorming,Tests"
16990,5,0.022522523,1.666666667,2019-09-30T09:37:14Z,2020-05-08T23:35:00Z,222,219,3,0.013513514,1,1,1,4,{'LD1': 1},1,0,{'LD1': 1},"Questions and Help,RPC/REST/ZMQ"
16992,3,1,1.5,2019-09-30T10:05:24Z,2019-10-03T09:46:36Z,3,1,2,0.666666667,1,2,1,2,{'LD2': 1},1,1,{'LD2': 1},Build system
16996,6,0.146341463,2,2019-09-30T12:45:31Z,2019-11-10T11:37:52Z,41,38,3,0.073170732,3,3,1,5,{'LD6': 1},1,2,{'LD6': 1},
17010,13,0.068062827,1.857142857,2019-10-01T10:24:29Z,2020-04-08T14:29:11Z,191,184,7,0.036649215,5,5,3,10,"{'LD3': 2, 'LD4': 1}",2,3,"{'LD3': 1, 'LD4': 1}","Bug,Linux/Unix"
17013,5,5,5,2019-10-01T17:05:51Z,2019-10-01T23:41:46Z,1,0,1,1,0,3,1,4,{'LD1': 1},1,2,{'LD1': 1},GUI
17019,4,0.181818182,4,2019-10-02T08:28:07Z,2019-10-23T09:22:16Z,22,21,1,0.045454545,2,2,2,2,"{'LD6': 1, 'LD3': 1}",1,1,"{'LD6': 1, 'LD3': 1}","Scripts and tools,Tests,good first issue"
17021,1,1,1,2019-10-02T12:18:46Z,2019-10-02T13:26:44Z,1,0,1,1,0,1,1,0,{'LD1': 1},1,0,{'LD1': 1},Bug
17025,7,3.5,7,2019-10-02T16:12:44Z,2019-10-04T10:19:58Z,2,1,1,0.5,1,5,4,3,"{'LD4': 2, 'LD3': 2}",4,1,"{'LD4': 2, 'LD3': 2}",Bug
17027,13,6.5,6.5,2019-10-02T19:34:55Z,2019-10-04T13:17:56Z,2,0,2,1,0,3,5,8,"{'LD4': 2, 'LD3': 2, 'LD1': 1}",3,0,"{'LD4': 1, 'LD3': 2, 'LD1': 1}","Bug,GUI"
17036,2,2,2,2019-10-03T03:05:42Z,2019-10-03T18:51:19Z,1,0,1,1,0,2,2,0,"{'LD1': 1, 'LD3': 1}",2,0,"{'LD1': 1, 'LD3': 1}","Linux/Unix,Utils/log/libs"
17047,1,0.003215434,1,2019-10-04T10:22:39Z,2020-08-10T07:05:41Z,311,310,1,0.003215434,1,1,1,0,{'LD2': 1},1,0,{'LD2': 1},GUI
17065,3,0.006535948,3,2019-10-06T08:40:19Z,2021-01-06T12:29:33Z,459,458,1,0.002178649,1,2,1,2,{'LD6': 1},1,1,{'LD6': 1},"Feature,RPC/REST/ZMQ"
17072,1,0.004761905,1,2019-10-07T14:43:50Z,2020-05-04T14:29:32Z,210,209,1,0.004761905,2,1,0,1,{},0,1,{},"Bug,GUI,RPC/REST/ZMQ"
17077,4,0.018691589,1.333333333,2019-10-08T17:40:35Z,2020-05-09T11:47:47Z,214,211,3,0.014018692,2,3,2,2,"{'LD4': 1, 'LD3': 1}",2,1,"{'LD4': 1, 'LD3': 1}",Build system
17079,7,0.225806452,2.333333333,2019-10-08T18:18:44Z,2019-11-08T13:32:43Z,31,28,3,0.096774194,2,7,1,6,{'LD4': 1},1,6,{'LD4': 1},Tests
17082,9,0.081081081,4.5,2019-10-09T09:32:38Z,2020-01-27T10:31:32Z,111,109,2,0.018018018,1,4,4,5,"{'LD3': 2, 'LD4': 1, 'LD6': 1}",2,2,"{'LD3': 2, 'LD4': 1, 'LD6': 1}","GUI,Hacktoberfest,good first issue"
17092,1,1,1,2019-10-09T23:27:43Z,2019-10-10T16:46:15Z,1,0,1,1,0,1,1,0,{'LD2': 1},1,0,{'LD2': 1},"Bug,GUI"
17107,3,0.015075377,1.5,2019-10-11T06:48:43Z,2020-04-26T16:17:32Z,199,197,2,0.010050251,2,2,1,2,{'LD1': 1},1,1,{'LD1': 1},"RPC/REST/ZMQ,Tests"
17112,13,0.5,3.25,2019-10-12T08:25:25Z,2019-11-06T13:29:44Z,26,22,4,0.153846154,1,3,5,8,"{'LD1': 1, 'LD4': 1, 'LD3': 2, 'LD5': 1}",3,0,"{'LD1': 1, 'LD4': 1, 'LD3': 2, 'LD5': 1}",Bug
17114,1,0.00877193,1,2019-10-12T09:55:22Z,2020-02-03T01:03:26Z,114,113,1,0.00877193,2,1,0,1,{},0,1,{},"Tests,macOS"
17117,1,0.2,1,2019-10-12T13:07:19Z,2019-10-16T14:01:00Z,5,4,1,0.2,2,1,0,1,{},0,1,{},"Bug,Docs"
17123,1,0.026315789,1,2019-10-13T11:04:13Z,2019-11-19T11:26:01Z,38,37,1,0.026315789,2,1,0,1,{},0,1,{},"Build system,GUI"
17130,6,0.352941176,3,2019-10-13T22:01:35Z,2019-10-30T21:41:20Z,17,15,2,0.117647059,3,2,1,5,{'LD1': 1},1,1,{'LD1': 1},"Bug,good first issue"
17139,4,0.222222222,2,2019-10-14T19:50:30Z,2019-11-01T10:09:11Z,18,16,2,0.111111111,1,3,0,4,{},0,3,{},Utils/log/libs
17144,2,0.5,2,2019-10-15T01:55:10Z,2019-10-19T01:19:54Z,4,3,1,0.25,1,1,2,0,"{'LD4': 1, 'LD2': 1}",1,0,"{'LD4': 1, 'LD2': 1}","Data corruption,Windows"
17148,1,0.25,1,2019-10-15T10:05:59Z,2019-10-19T01:16:54Z,4,3,1,0.25,1,1,0,1,{},0,1,{},Questions and Help
17149,6,0.056074766,1.5,2019-10-15T10:37:14Z,2020-01-29T11:40:37Z,107,103,4,0.037383178,3,4,1,5,{'LD2': 1},1,3,{'LD2': 1},"Bug,PSBT"
17150,1,1,1,2019-10-15T16:49:14Z,2019-10-15T18:34:56Z,1,0,1,1,0,1,1,0,{'LD4': 1},1,0,{'LD4': 1},Build system
17153,19,0.063333333,6.333333333,2019-10-15T18:04:28Z,2020-08-10T07:25:20Z,300,297,3,0.01,2,5,10,9,"{'LD4': 3, 'LD1': 4, 'LD3': 3}",3,2,"{'LD4': 2, 'LD1': 1, 'LD3': 2}","Bug,GUI,Linux/Unix"
17155,11,0.053921569,3.666666667,2019-10-15T19:16:43Z,2020-05-06T18:24:53Z,204,201,3,0.014705882,1,8,6,5,"{'LD4': 3, 'LD3': 3}",5,3,"{'LD4': 2, 'LD3': 3}","RPC/REST/ZMQ,Wallet"
17170,5,0.045045045,2.5,2019-10-17T06:56:38Z,2020-02-05T03:16:34Z,111,109,2,0.018018018,2,3,2,3,"{'LD1': 1, 'LD3': 1}",2,1,"{'LD1': 1, 'LD3': 1}",Windows
17173,2,0.057142857,2,2019-10-17T13:43:29Z,2019-11-20T13:49:13Z,35,34,1,0.028571429,2,2,2,0,"{'LD4': 1, 'LD3': 1}",2,0,"{'LD4': 1, 'LD3': 1}","Brainstorming,Feature,GUI"
17178,3,0.0625,1.5,2019-10-17T15:34:34Z,2019-12-03T16:04:29Z,48,46,2,0.041666667,3,3,1,2,{'LD3': 1},1,2,{'LD3': 1},"Tests,good first issue,macOS"
17179,4,2,4,2019-10-17T18:07:55Z,2019-10-18T21:38:48Z,2,1,1,0.5,1,3,1,3,{'LD4': 1},1,2,{'LD4': 1},macOS
17181,5,0.454545455,5,2019-10-17T20:38:50Z,2019-10-28T11:00:58Z,11,10,1,0.090909091,1,2,2,3,{'LD1': 2},1,1,{'LD1': 1},RPC/REST/ZMQ
17185,5,0.060240964,1.25,2019-10-18T07:13:01Z,2020-01-08T14:20:50Z,83,79,4,0.048192771,3,2,3,2,"{'LD1': 1, 'LD3': 2}",2,0,"{'LD1': 1, 'LD3': 2}","Bug,RPC/REST/ZMQ,Windows"
17188,1,1,1,2019-10-18T12:48:38Z,2019-10-18T12:55:54Z,1,0,1,1,0,1,0,1,{},0,1,{},"Bug,Tests,macOS"
17200,1,0.005263158,1,2019-10-20T11:47:30Z,2020-04-26T17:18:41Z,190,189,1,0.005263158,1,1,0,1,{},0,1,{},Resource usage
17217,4,0.037383178,1.333333333,2019-10-22T15:13:57Z,2020-02-05T15:32:36Z,107,104,3,0.028037383,2,2,2,2,"{'LD6': 1, 'LD5': 1}",2,0,"{'LD6': 1, 'LD5': 1}",Docs
17236,6,6,6,2019-10-24T02:33:24Z,2019-10-24T23:11:05Z,1,0,1,1,0,3,1,5,{'LD1': 1},1,2,{'LD1': 1},Questions and Help
17244,1,1,1,2019-10-24T22:01:11Z,2019-10-24T22:31:38Z,1,0,1,1,0,1,0,1,{},0,1,{},"Bug,Build system"
17247,9,0.048648649,4.5,2019-10-25T10:08:11Z,2020-04-27T01:14:28Z,185,183,2,0.010810811,1,4,4,5,"{'LD1': 1, 'LD4': 3}",3,1,"{'LD1': 1, 'LD4': 2}","P2P,Questions and Help,Waiting for author"
17255,2,2,2,2019-10-25T16:22:07Z,2019-10-25T18:45:24Z,1,0,1,1,0,2,2,0,"{'LD4': 1, 'LD2': 1}",2,0,"{'LD4': 1, 'LD2': 1}",
17262,7,0.035714286,2.333333333,2019-10-26T09:22:58Z,2020-05-08T23:36:41Z,196,193,3,0.015306122,3,4,1,6,{'LD3': 1},1,3,{'LD3': 1},"Questions and Help,RPC/REST/ZMQ"
17263,3,0.006833713,1,2019-10-26T09:28:51Z,2021-01-06T12:30:11Z,439,436,3,0.006833713,4,3,2,1,"{'LD4': 1, 'LD5': 1}",2,1,"{'LD4': 1, 'LD5': 1}","Bug,GUI"
17269,1,0.005434783,1,2019-10-27T00:52:26Z,2020-04-27T05:56:37Z,184,183,1,0.005434783,1,1,1,0,{'LD5': 1},1,0,{'LD5': 1},GUI
17277,12,0.048192771,1.333333333,2019-10-28T00:21:03Z,2020-07-02T02:07:40Z,249,240,9,0.036144578,6,3,3,9,"{'LD4': 2, 'LD1': 1}",3,0,"{'LD4': 2, 'LD1': 1}",Windows
17287,4,0.036363636,1.333333333,2019-10-28T19:10:44Z,2020-02-15T18:43:48Z,110,107,3,0.027272727,3,3,1,3,{'LD5': 1},1,2,{'LD5': 1},"Build system,Windows"
17294,4,0.026143791,2,2019-10-29T00:53:42Z,2020-03-29T12:17:17Z,153,151,2,0.013071895,2,3,3,1,"{'LD3': 1, 'LD6': 2}",3,0,"{'LD3': 1, 'LD6': 2}","Bug,Docs,good first issue"
17296,1,0.066666667,1,2019-10-29T09:11:27Z,2019-11-12T19:45:41Z,15,14,1,0.066666667,1,1,1,0,{'LD3': 1},1,0,{'LD3': 1},"Feature,Wallet"
17307,6,0.013015184,2,2019-10-29T20:22:14Z,2021-02-01T12:28:19Z,461,458,3,0.006507592,3,4,2,4,{'LD6': 2},2,2,{'LD6': 2},Utils/log/libs
17313,5,0.03968254,1.666666667,2019-10-30T09:54:44Z,2020-03-03T20:11:37Z,126,123,3,0.023809524,2,3,2,3,"{'LD4': 1, 'LD3': 1}",1,2,"{'LD4': 1, 'LD3': 1}",Utils/log/libs
17315,2,0.1,2,2019-10-30T12:38:21Z,2019-11-18T13:39:53Z,20,19,1,0.05,1,2,1,1,{'LD2': 1},1,1,{'LD2': 1},"Bug,Build system,Upstream"
17317,7,1,3.5,2019-10-30T13:50:22Z,2019-11-06T13:00:58Z,7,5,2,0.285714286,1,5,5,2,"{'LD6': 2, 'LD4': 1, 'LD3': 2}",3,2,"{'LD6': 2, 'LD4': 1, 'LD3': 2}","Brainstorming,Docs"
17321,3,0.016666667,1,2019-10-30T16:28:08Z,2020-04-26T17:20:46Z,180,177,3,0.016666667,3,3,1,2,{'LD4': 1},1,2,{'LD4': 1},Questions and Help
17323,12,0.104347826,1.714285714,2019-10-30T17:39:39Z,2020-02-22T15:28:20Z,115,108,7,0.060869565,3,2,5,7,"{'LD3': 1, 'LD4': 2, 'LD1': 2}",2,0,"{'LD3': 1, 'LD4': 1, 'LD1': 2}","Bug,Build system"
17326,14,0.138613861,2,2019-10-30T21:09:01Z,2020-02-08T13:35:23Z,101,94,7,0.069306931,5,6,3,11,"{'LD1': 1, 'LD3': 2}",3,3,"{'LD1': 1, 'LD3': 2}","Brainstorming,P2P"
17333,1,1,1,2019-10-31T20:45:35Z,2019-10-31T22:56:49Z,1,0,1,1,0,1,1,0,{'LD1': 1},1,0,{'LD1': 1},
17334,1,1,1,2019-10-31T21:23:12Z,2019-10-31T21:38:28Z,1,0,1,1,0,1,1,0,{'LD2': 1},1,0,{'LD2': 1},Bug
17337,1,1,1,2019-11-01T12:00:30Z,2019-11-01T14:12:07Z,1,0,1,1,0,1,0,1,{},0,1,{},"Linux/Unix,Questions and Help"
17341,2,0.5,1,2019-11-01T14:39:07Z,2019-11-05T00:50:04Z,4,2,2,0.5,1,2,1,1,{'LD3': 1},1,1,{'LD3': 1},"Data corruption,Feature"
17344,14,0.048109966,2,2019-11-01T15:58:47Z,2020-08-18T05:00:34Z,291,284,7,0.024054983,7,5,4,10,"{'LD1': 1, 'LD3': 2, 'LD6': 1}",3,2,"{'LD1': 1, 'LD3': 2, 'LD6': 1}","Brainstorming,Build system"
17348,8,0.04519774,2.666666667,2019-11-01T19:56:01Z,2020-04-26T17:21:48Z,177,174,3,0.016949153,3,4,5,3,"{'LD4': 1, 'LD1': 3, 'LD3': 1}",3,1,"{'LD4': 1, 'LD1': 2, 'LD3': 1}",GUI
17352,2,0.4,2,2019-11-02T14:55:50Z,2019-11-07T08:44:03Z,5,4,1,0.2,2,2,0,2,{},0,2,{},"RPC/REST/ZMQ,Tests"
17372,2,0.125,1,2019-11-04T23:14:10Z,2019-11-20T21:43:41Z,16,14,2,0.125,3,1,0,2,{},0,1,{},"Feature,Tests"
17394,1,0.007142857,1,2019-11-06T13:09:06Z,2020-03-24T15:26:02Z,140,139,1,0.007142857,2,1,1,0,{'LD6': 1},1,0,{'LD6': 1},"Tests,good first issue"
17395,20,0.071942446,4,2019-11-06T14:32:26Z,2020-08-10T06:01:17Z,278,273,5,0.017985612,4,11,5,15,"{'LD3': 4, 'LD4': 1}",5,6,"{'LD3': 4, 'LD4': 1}","Brainstorming,GUI"
17401,5,0.3125,5,2019-11-07T13:09:58Z,2019-11-22T14:23:29Z,16,15,1,0.0625,2,1,1,4,{'LD6': 1},1,0,{'LD6': 1},"Build system,Tests,good first issue"
17419,2,1,2,2019-11-08T14:58:29Z,2019-11-09T23:00:12Z,2,1,1,0.5,1,2,2,0,{'LD3': 2},2,0,{'LD3': 2},"Feature,Wallet"
17429,7,1.166666667,3.5,2019-11-09T23:07:46Z,2019-11-15T16:35:05Z,6,4,2,0.333333333,1,6,2,5,{'LD3': 2},2,4,{'LD3': 2},"Feature,Wallet"
17441,3,0.035294118,1.5,2019-11-11T16:56:50Z,2020-02-04T12:22:40Z,85,83,2,0.023529412,1,3,1,2,{'LD4': 1},1,2,{'LD4': 1},Questions and Help
17451,6,0.088235294,1.5,2019-11-12T07:57:13Z,2020-01-18T13:46:16Z,68,64,4,0.058823529,3,4,2,4,"{'LD4': 1, 'LD1': 1}",2,2,"{'LD4': 1, 'LD1': 1}","Bug,P2P"
17460,3,0.085714286,1.5,2019-11-13T00:58:48Z,2019-12-17T16:47:50Z,35,33,2,0.057142857,3,2,1,2,{'LD4': 1},1,1,{'LD4': 1},"Feature,Tests"
17465,1,1,1,2019-11-13T16:08:59Z,2019-11-13T16:22:50Z,1,0,1,1,0,1,0,1,{},0,1,{},"Docs,Tests"
17467,4,0.02247191,1.333333333,2019-11-13T19:15:30Z,2020-05-08T23:42:41Z,178,175,3,0.016853933,2,2,3,1,"{'LD4': 1, 'LD1': 1, 'LD3': 1}",2,0,"{'LD4': 1, 'LD1': 1, 'LD3': 1}","Bug,GUI"
17468,1,0.006060606,1,2019-11-13T21:08:24Z,2020-04-26T18:31:56Z,165,164,1,0.006060606,2,1,1,0,{'LD4': 1},1,0,{'LD4': 1},"Bug,Build system"
17476,4,4,4,2019-11-14T15:47:07Z,2019-11-15T09:57:21Z,1,0,1,1,0,4,2,2,"{'LD1': 1, 'LD4': 1}",2,2,"{'LD1': 1, 'LD4': 1}",Build system
17478,10,0.087719298,2.5,2019-11-14T16:52:11Z,2020-03-07T14:59:35Z,114,110,4,0.035087719,3,6,6,4,"{'LD4': 2, 'LD3': 4}",5,1,"{'LD4': 2, 'LD3': 3}",Build system
17481,1,1,1,2019-11-14T19:10:22Z,2019-11-14T19:21:48Z,1,0,1,1,0,1,0,1,{},0,1,{},Bug
17495,3,0.015384615,1.5,2019-11-16T17:07:42Z,2020-05-29T13:50:04Z,195,193,2,0.01025641,3,2,0,3,{},0,2,{},GUI
17501,2,0.08,2,2019-11-17T21:46:32Z,2019-12-12T09:57:31Z,25,24,1,0.04,1,1,0,2,{},0,1,{},Resource usage
17504,18,0.211764706,2,2019-11-18T11:07:46Z,2020-02-11T08:32:28Z,85,76,9,0.105882353,8,9,5,13,"{'LD3': 3, 'LD2': 2}",4,5,"{'LD3': 3, 'LD2': 1}",Build system
17523,9,1.8,9,2019-11-19T20:14:07Z,2019-11-24T10:20:20Z,5,4,1,0.2,1,4,5,4,"{'LD4': 3, 'LD1': 2}",3,1,"{'LD4': 3, 'LD1': 1}","Bug,Linux/Unix,Utils/log/libs"
17525,3,0.5,3,2019-11-19T22:12:19Z,2019-11-24T23:45:15Z,6,5,1,0.166666667,1,3,2,1,"{'LD3': 1, 'LD6': 1}",2,1,"{'LD3': 1, 'LD6': 1}","Bug,Build system"
17528,1,1,1,2019-11-19T23:01:47Z,2019-11-19T23:36:39Z,1,0,1,1,0,1,0,1,{},0,1,{},
17534,1,0.003787879,1,2019-11-20T14:56:06Z,2020-08-10T07:00:14Z,264,263,1,0.003787879,1,1,0,1,{},0,1,{},"GUI,Linux/Unix"
17546,11,0.06918239,2.2,2019-11-20T21:59:20Z,2020-04-27T00:14:58Z,159,154,5,0.031446541,3,3,3,8,"{'LD3': 1, 'LD4': 2}",2,1,"{'LD3': 1, 'LD4': 2}","Feature,Tests"
17548,3,0.017647059,1,2019-11-21T15:47:40Z,2020-05-08T23:29:36Z,170,167,3,0.017647059,2,3,1,2,{'LD3': 1},1,2,{'LD3': 1},"Brainstorming,Feature,RPC/REST/ZMQ"
17572,1,0.006410256,1,2019-11-23T14:24:28Z,2020-04-26T17:23:24Z,156,155,1,0.006410256,2,1,1,0,{'LD1': 1},1,0,{'LD1': 1},Bug
17576,3,1.5,3,2019-11-24T14:53:21Z,2019-11-25T15:47:24Z,2,1,1,0.5,1,3,3,0,"{'LD2': 1, 'LD3': 2}",3,0,"{'LD2': 1, 'LD3': 2}","Bug,GUI"
17582,1,0.0625,1,2019-11-24T20:32:14Z,2019-12-10T17:14:27Z,16,15,1,0.0625,1,1,1,0,{'LD4': 1},1,0,{'LD4': 1},"Bug,Linux/Unix"
17586,5,5,5,2019-11-25T10:12:36Z,2019-11-25T20:48:45Z,1,0,1,1,0,3,2,3,"{'LD3': 1, 'LD1': 1}",2,1,"{'LD3': 1, 'LD1': 1}",Tests
17588,1,0.002444988,1,2019-11-25T10:45:24Z,2021-01-06T12:31:01Z,409,408,1,0.002444988,2,1,1,0,{'LD6': 1},1,0,{'LD6': 1},good first issue
17589,3,0.15,1,2019-11-25T12:32:40Z,2019-12-15T10:16:41Z,20,17,3,0.15,4,3,2,1,"{'LD1': 1, 'LD2': 1}",2,1,"{'LD1': 1, 'LD2': 1}","P2P,Upstream"
17594,9,4.5,4.5,2019-11-25T14:56:14Z,2019-11-26T17:17:42Z,2,0,2,1,0,3,2,7,"{'LD2': 1, 'LD5': 1}",1,2,"{'LD2': 1, 'LD5': 1}",Brainstorming
17603,5,0.034722222,1.666666667,2019-11-25T22:32:01Z,2020-04-17T11:08:06Z,144,141,3,0.020833333,4,3,2,3,"{'LD6': 1, 'LD4': 1}",2,1,"{'LD6': 1, 'LD4': 1}","Bug,Wallet"
17605,4,0.093023256,2,2019-11-25T23:13:28Z,2020-01-07T22:13:37Z,43,41,2,0.046511628,2,2,0,4,{},0,2,{},"Bug,Wallet"
17607,2,0.028169014,1,2019-11-26T00:47:34Z,2020-02-04T01:53:33Z,71,69,2,0.028169014,1,1,1,1,{'LD2': 1},1,0,{'LD2': 1},GUI
17608,1,1,1,2019-11-26T08:23:32Z,2019-11-26T14:04:55Z,1,0,1,1,0,1,1,0,{'LD4': 1},1,0,{'LD4': 1},
17613,1,0.058823529,1,2019-11-26T16:08:03Z,2019-12-13T09:54:38Z,17,16,1,0.058823529,1,1,0,1,{},0,1,{},"Docs,good first issue"
17616,3,3,3,2019-11-26T19:22:05Z,2019-11-27T14:44:47Z,1,0,1,1,0,1,0,3,{},0,1,{},Questions and Help
17618,6,0.026548673,2,2019-11-27T06:54:41Z,2020-07-09T14:28:45Z,226,223,3,0.013274336,2,3,2,4,"{'LD4': 1, 'LD6': 1}",2,1,"{'LD4': 1, 'LD6': 1}","GUI,RPC/REST/ZMQ"
17620,12,0.073619632,4,2019-11-27T15:17:50Z,2020-05-07T16:45:03Z,163,160,3,0.018404908,3,3,7,5,"{'LD1': 5, 'LD3': 1, 'LD4': 1}",2,1,"{'LD1': 1, 'LD3': 1, 'LD4': 1}",
17622,2,2,2,2019-11-27T16:51:45Z,2019-11-27T16:55:08Z,1,0,1,1,0,2,0,2,{},0,2,{},Questions and Help
17626,1,1,1,2019-11-28T09:06:08Z,2019-11-29T08:49:41Z,1,0,1,1,0,1,0,1,{},0,1,{},Tests
17628,1,0.111111111,1,2019-11-28T10:54:39Z,2019-12-07T04:33:02Z,9,8,1,0.111111111,1,1,0,1,{},0,1,{},Feature
17632,1,0.03030303,1,2019-11-29T08:48:47Z,2019-12-31T18:02:35Z,33,32,1,0.03030303,2,1,0,1,{},0,1,{},
17638,11,2.2,5.5,2019-11-30T08:36:09Z,2019-12-04T18:01:05Z,5,3,2,0.4,1,4,5,6,"{'LD2': 2, 'LD4': 2, 'LD3': 1}",3,1,"{'LD2': 2, 'LD4': 2, 'LD3': 1}",Tests
17652,4,4,4,2019-12-02T17:24:03Z,2019-12-03T09:31:58Z,1,0,1,1,0,3,1,3,{'LD2': 1},1,2,{'LD2': 1},Docs
17656,1,0.25,1,2019-12-03T12:34:28Z,2019-12-07T09:14:52Z,4,3,1,0.25,1,1,0,1,{},0,1,{},"Tests,good first issue"
17662,1,1,1,2019-12-03T23:06:40Z,2019-12-04T13:01:45Z,1,0,1,1,0,1,0,1,{},0,1,{},Questions and Help
17664,1,1,1,2019-12-04T00:12:56Z,2019-12-04T03:32:14Z,1,0,1,1,0,1,1,0,{'LD1': 1},1,0,{'LD1': 1},"Questions and Help,Upstream,macOS"
17672,1,0.333333333,1,2019-12-05T08:02:29Z,2019-12-07T09:28:16Z,3,2,1,0.333333333,1,1,1,0,{'LD5': 1},1,0,{'LD5': 1},"Bug,GUI,Upstream"
17679,3,0.428571429,1.5,2019-12-05T18:59:05Z,2019-12-12T13:04:39Z,7,5,2,0.285714286,1,3,2,1,"{'LD1': 1, 'LD6': 1}",2,1,"{'LD1': 1, 'LD6': 1}","Bug,good first issue"
17683,2,0.666666667,1,2019-12-06T15:16:05Z,2019-12-09T14:55:17Z,3,1,2,0.666666667,1,1,0,2,{},0,1,{},"GUI,good first issue"
17690,8,1,4,2019-12-07T13:42:31Z,2019-12-15T09:41:19Z,8,6,2,0.25,1,3,6,2,"{'LD4': 4, 'LD1': 1, 'LD2': 1}",3,0,"{'LD4': 3, 'LD1': 1, 'LD2': 1}",Wallet
17692,1,0.5,1,2019-12-07T17:22:34Z,2019-12-08T18:54:36Z,2,1,1,0.5,1,1,0,1,{},0,1,{},Feature
17706,1,0.333333333,1,2019-12-09T21:34:42Z,2019-12-12T20:28:33Z,3,2,1,0.333333333,1,1,0,1,{},0,1,{},Feature
17711,2,0.014388489,2,2019-12-10T16:47:59Z,2020-04-26T22:45:05Z,139,138,1,0.007194245,1,2,1,1,{'LD1': 1},1,1,{'LD1': 1},"Feature,RPC/REST/ZMQ"
17716,2,0.021978022,1,2019-12-10T21:40:57Z,2020-03-10T18:16:54Z,91,89,2,0.021978022,1,1,1,1,{'LD6': 1},1,0,{'LD6': 1},"Bug,Tests"
17717,6,0.015228426,1.2,2019-12-10T22:31:38Z,2021-01-06T23:23:54Z,394,389,5,0.012690355,4,6,2,4,"{'LD3': 1, 'LD5': 1}",2,4,"{'LD3': 1, 'LD5': 1}",Feature
17718,1,0.333333333,1,2019-12-10T23:21:42Z,2019-12-13T10:15:40Z,3,2,1,0.333333333,2,1,0,1,{},0,1,{},Utils/log/libs
17729,1,1,1,2019-12-11T23:43:01Z,2019-12-12T00:34:56Z,1,0,1,1,0,1,1,0,{'LD2': 1},1,0,{'LD2': 1},Bug
17733,3,0.007352941,3,2019-12-12T12:32:02Z,2021-01-22T23:11:25Z,408,407,1,0.00245098,1,2,0,3,{},0,2,{},"Bug,GUI"
17734,1,0.004132231,1,2019-12-12T14:05:02Z,2020-08-10T12:29:39Z,242,241,1,0.004132231,2,1,1,0,{'LD3': 1},1,0,{'LD3': 1},"Feature,GUI"
17742,4,0.066666667,1.333333333,2019-12-13T10:33:46Z,2020-02-10T11:57:53Z,60,57,3,0.05,2,3,0,4,{},0,3,{},"Bug,Utils/log/libs"
17749,1,0.5,1,2019-12-15T12:10:24Z,2019-12-17T08:10:33Z,2,1,1,0.5,1,1,0,1,{},0,1,{},"Build system,Upstream"
17757,2,0.064516129,1,2019-12-16T22:21:24Z,2020-01-16T20:54:27Z,31,29,2,0.064516129,2,2,1,1,{'LD3': 1},1,1,{'LD3': 1},"Brainstorming,Tests,good first issue"
17763,1,0.007246377,1,2019-12-17T16:55:36Z,2020-05-03T14:39:18Z,138,137,1,0.007246377,1,1,1,0,{'LD6': 1},1,0,{'LD6': 1},Tests
17776,1,1,1,2019-12-19T17:44:37Z,2019-12-19T17:56:10Z,1,0,1,1,0,1,0,1,{},0,1,{},"P2P,Questions and Help"
17778,1,1,1,2019-12-20T09:40:52Z,2019-12-20T14:18:42Z,1,0,1,1,0,1,1,0,{'LD2': 1},1,0,{'LD2': 1},Feature
17780,2,0.4,1,2019-12-20T10:38:13Z,2019-12-24T15:36:22Z,5,3,2,0.4,2,1,1,1,{'LD1': 1},1,0,{'LD1': 1},
17784,2,0.25,1,2019-12-20T16:18:10Z,2019-12-27T17:44:45Z,8,6,2,0.25,1,2,1,1,{'LD4': 1},1,1,{'LD4': 1},Bug
17802,10,0.03003003,2.5,2019-12-27T11:32:33Z,2020-11-23T20:06:52Z,333,329,4,0.012012012,4,4,5,5,"{'LD5': 1, 'LD1': 1, 'LD4': 2, 'LD6': 1}",3,1,"{'LD5': 1, 'LD1': 1, 'LD4': 2, 'LD6': 1}",Tests
17803,17,0.425,2.428571429,2019-12-27T13:53:59Z,2020-02-04T22:22:34Z,40,33,7,0.175,5,5,6,11,"{'LD4': 3, 'LD3': 1, 'LD2': 1, 'LD5': 1}",4,1,"{'LD4': 2, 'LD3': 1, 'LD2': 1, 'LD5': 1}","Tests,Upstream"
17813,6,0.035714286,1.5,2019-12-28T15:17:05Z,2020-06-13T12:46:45Z,168,164,4,0.023809524,3,2,4,2,"{'LD4': 2, 'LD3': 1, 'LD6': 1}",2,0,"{'LD4': 2, 'LD3': 1, 'LD6': 1}","Build system,GUI"
17827,11,0.458333333,1.833333333,2019-12-29T20:37:47Z,2020-01-22T15:48:45Z,24,18,6,0.25,4,5,5,6,"{'LD1': 1, 'LD4': 3, 'LD6': 1}",2,3,"{'LD1': 1, 'LD4': 2, 'LD6': 1}","Bug,macOS"
17832,1,0.047619048,1,2019-12-30T09:24:31Z,2020-01-20T00:58:34Z,21,20,1,0.047619048,2,1,0,1,{},0,1,{},
17835,1,1,1,2019-12-30T20:44:19Z,2019-12-30T22:46:23Z,1,0,1,1,0,1,0,1,{},0,1,{},Bug
17846,1,0.029411765,1,2020-01-02T07:31:54Z,2020-02-04T12:21:45Z,34,33,1,0.029411765,1,1,1,0,{'LD4': 1},1,0,{'LD4': 1},
17848,1,1,1,2020-01-02T14:33:50Z,2020-01-02T18:53:07Z,1,0,1,1,0,1,0,1,{},0,1,{},"Bug,Tests,macOS"
17856,1,0.05,1,2020-01-03T09:15:58Z,2020-01-23T01:32:07Z,20,19,1,0.05,1,1,1,0,{'LD2': 1},1,0,{'LD2': 1},Bug
17864,14,0.4375,3.5,2020-01-04T05:55:29Z,2020-02-04T12:21:27Z,32,28,4,0.125,2,3,9,5,"{'LD1': 6, 'LD5': 1, 'LD4': 2}",2,1,"{'LD1': 1, 'LD5': 1, 'LD4': 1}",Windows
17866,14,0.122807018,2,2020-01-04T06:27:13Z,2020-04-27T01:17:58Z,114,107,7,0.061403509,6,6,4,10,"{'LD3': 1, 'LD4': 2, 'LD6': 1}",4,2,"{'LD3': 1, 'LD4': 2, 'LD6': 1}",good first issue
17870,2,0.00913242,1,2020-01-04T13:32:20Z,2020-08-10T12:31:32Z,219,217,2,0.00913242,3,2,1,1,{'LD2': 1},1,1,{'LD2': 1},"Feature,GUI"
17871,3,0.5,1.5,2020-01-05T01:44:38Z,2020-01-10T10:39:30Z,6,4,2,0.333333333,2,1,1,2,{'LD3': 1},1,0,{'LD3': 1},Feature
17875,1,1,1,2020-01-05T08:35:27Z,2020-01-05T22:36:52Z,1,0,1,1,0,1,0,1,{},0,1,{},"Tests,Windows"
17885,3,0.027027027,1.5,2020-01-06T22:33:48Z,2020-04-26T17:23:48Z,111,109,2,0.018018018,2,3,0,3,{},0,3,{},Feature
17903,6,1.5,6,2020-01-10T15:06:27Z,2020-01-13T17:25:23Z,4,3,1,0.25,1,3,3,3,"{'LD2': 1, 'LD3': 1, 'LD6': 1}",2,1,"{'LD2': 1, 'LD3': 1, 'LD6': 1}",Questions and Help
17909,2,0.166666667,2,2020-01-11T17:37:25Z,2020-01-23T01:32:15Z,12,11,1,0.083333333,1,1,2,0,"{'LD1': 1, 'LD3': 1}",1,0,"{'LD1': 1, 'LD3': 1}",Bug
17911,3,0.115384615,1.5,2020-01-12T04:36:36Z,2020-02-06T06:43:49Z,26,24,2,0.076923077,2,2,0,3,{},0,2,{},"Bug,GUI"
17912,4,1.333333333,2,2020-01-12T13:40:28Z,2020-01-14T19:28:58Z,3,1,2,0.666666667,1,1,3,1,"{'LD4': 1, 'LD3': 1, 'LD5': 1}",1,0,"{'LD4': 1, 'LD3': 1, 'LD5': 1}",Questions and Help
17914,2,0.117647059,2,2020-01-13T01:21:06Z,2020-01-29T13:47:36Z,17,16,1,0.058823529,1,1,2,0,"{'LD6': 1, 'LD3': 1}",1,0,"{'LD6': 1, 'LD3': 1}","Docs,good first issue,macOS"
17927,4,2,4,2020-01-15T06:37:28Z,2020-01-16T13:56:21Z,2,1,1,0.5,1,3,1,3,{'LD3': 1},1,2,{'LD3': 1},"GUI,good first issue"
17952,5,0.044642857,5,2020-01-17T17:40:30Z,2020-05-07T23:30:18Z,112,111,1,0.008928571,2,3,2,3,"{'LD6': 1, 'LD3': 1}",2,1,"{'LD6': 1, 'LD3': 1}",Feature
17960,3,1.5,3,2020-01-19T00:03:32Z,2020-01-20T19:43:45Z,2,1,1,0.5,1,2,2,1,{'LD4': 2},2,0,{'LD4': 2},
17967,2,0.015267176,2,2020-01-19T19:39:09Z,2020-05-29T08:30:44Z,131,130,1,0.007633588,1,1,0,2,{},0,1,{},"Bug,GUI"
17969,1,0.004807692,1,2020-01-20T22:31:34Z,2020-08-15T00:27:42Z,208,207,1,0.004807692,1,1,0,1,{},0,1,{},"Bug,GUI"
17970,1,1,1,2020-01-20T22:52:16Z,2020-01-21T03:14:04Z,1,0,1,1,0,1,0,1,{},0,1,{},
17976,9,1.5,3,2020-01-21T17:20:45Z,2020-01-27T11:37:46Z,6,3,3,0.5,1,3,2,7,{'LD5': 2},2,1,{'LD5': 2},"Brainstorming,Tests"
17986,1,0.017857143,1,2020-01-22T21:58:43Z,2020-03-18T19:49:35Z,56,55,1,0.017857143,2,1,0,1,{},0,1,{},"Feature,Tests"
18015,2,1,2,2020-01-28T20:05:57Z,2020-01-30T13:53:11Z,2,1,1,0.5,1,1,2,0,"{'LD3': 1, 'LD6': 1}",1,0,"{'LD3': 1, 'LD6': 1}","Bug,Windows"
18016,1,0.01,1,2020-01-29T00:40:38Z,2020-05-07T14:28:36Z,100,99,1,0.01,2,1,1,0,{'LD4': 1},1,0,{'LD4': 1},"Bug,Tests,Upstream"
18019,5,0.125,1.25,2020-01-29T13:12:47Z,2020-03-09T09:07:18Z,40,36,4,0.1,4,5,1,4,{'LD4': 1},1,4,{'LD4': 1},"Tests,good first issue"
18033,4,0.036363636,1.333333333,2020-01-30T23:18:35Z,2020-05-19T11:25:08Z,110,107,3,0.027272727,2,4,2,2,"{'LD3': 1, 'LD5': 1}",2,2,"{'LD3': 1, 'LD5': 1}",P2P
18039,1,0.002923977,1,2020-01-31T09:36:23Z,2021-01-06T12:32:30Z,342,341,1,0.002923977,1,1,0,1,{},0,1,{},"Docs,Wallet"
18043,1,0.002932551,1,2020-01-31T16:24:11Z,2021-01-06T12:33:40Z,341,340,1,0.002932551,1,1,0,1,{},0,1,{},Feature
18046,9,0.142857143,1.8,2020-01-31T21:56:37Z,2020-04-02T22:51:19Z,63,58,5,0.079365079,6,4,4,5,"{'LD3': 1, 'LD2': 1, 'LD5': 2}",3,1,"{'LD3': 1, 'LD2': 1, 'LD5': 2}",
18058,3,3,3,2020-02-03T05:50:32Z,2020-02-03T09:09:06Z,1,0,1,1,0,1,3,0,"{'LD1': 2, 'LD3': 1}",1,0,"{'LD1': 1, 'LD3': 1}",Bug
18065,3,0.045454545,1.5,2020-02-04T01:44:44Z,2020-04-09T09:08:17Z,66,64,2,0.03030303,2,2,1,2,{'LD5': 1},1,1,{'LD5': 1},"Brainstorming,Bug"
18075,2,0.142857143,1,2020-02-05T15:52:52Z,2020-02-19T01:46:31Z,14,12,2,0.142857143,2,2,0,2,{},0,2,{},"Bug,Wallet"
18080,10,2,5,2020-02-06T03:53:34Z,2020-02-10T11:30:58Z,5,3,2,0.4,2,2,4,6,"{'LD3': 2, 'LD6': 2}",2,0,"{'LD3': 2, 'LD6': 1}","GUI,good first issue"
18090,4,1,4,2020-02-07T06:02:49Z,2020-02-10T11:24:26Z,4,3,1,0.25,1,2,1,3,{'LD3': 1},1,1,{'LD3': 1},"Bug,GUI,Tests"
18103,3,3,3,2020-02-09T20:03:36Z,2020-02-10T19:14:24Z,1,0,1,1,0,2,0,3,{},0,2,{},Bug
18111,5,0.416666667,2.5,2020-02-10T20:50:03Z,2020-02-22T15:22:02Z,12,10,2,0.166666667,2,2,3,2,"{'LD3': 2, 'LD4': 1}",1,1,"{'LD3': 1, 'LD4': 1}",Tests
18132,6,0.0375,1.2,2020-02-12T20:15:33Z,2020-07-21T08:14:13Z,160,155,5,0.03125,4,4,1,5,{'LD6': 1},1,3,{'LD6': 1},"Tests,good first issue"
18136,3,0.035294118,1.5,2020-02-13T09:00:19Z,2020-05-07T22:45:53Z,85,83,2,0.023529412,1,2,1,2,{'LD4': 1},1,1,{'LD4': 1},GUI
18144,1,0.333333333,1,2020-02-14T07:03:17Z,2020-02-17T02:55:36Z,3,2,1,0.333333333,1,1,1,0,{'LD4': 1},1,0,{'LD4': 1},Bug
18177,4,0.05,4,2020-02-19T10:12:35Z,2020-05-09T00:04:53Z,80,79,1,0.0125,1,3,1,3,{'LD3': 1},1,2,{'LD3': 1},Feature
18180,1,0.035714286,1,2020-02-19T15:57:50Z,2020-03-17T17:27:09Z,28,27,1,0.035714286,2,1,0,1,{},0,1,{},Feature
18182,3,3,3,2020-02-19T18:13:41Z,2020-02-19T20:41:33Z,1,0,1,1,0,2,1,2,{'LD1': 1},1,1,{'LD1': 1},
18198,2,0.03030303,1,2020-02-23T15:07:22Z,2020-04-29T14:34:15Z,66,64,2,0.03030303,2,2,2,0,"{'LD3': 1, 'LD4': 1}",2,0,"{'LD3': 1, 'LD4': 1}",Brainstorming
18203,1,1,1,2020-02-24T22:09:00Z,2020-02-24T22:42:32Z,1,0,1,1,0,1,0,1,{},0,1,{},Bug
18205,1,0.333333333,1,2020-02-25T00:35:58Z,2020-02-27T21:13:41Z,3,2,1,0.333333333,1,1,0,1,{},0,1,{},"Docs,good first issue"
18215,1,0.016949153,1,2020-02-27T22:27:18Z,2020-04-26T17:25:48Z,59,58,1,0.016949153,2,1,1,0,{'LD4': 1},1,0,{'LD4': 1},Wallet
18221,1,1,1,2020-02-28T11:58:45Z,2020-02-28T14:37:53Z,1,0,1,1,0,1,1,0,{'LD2': 1},1,0,{'LD2': 1},Feature
18227,7,1,3.5,2020-02-28T20:36:59Z,2020-03-06T19:52:53Z,7,5,2,0.285714286,1,4,2,5,{'LD4': 2},2,2,{'LD4': 2},"Bug,Tests,Upstream"
18254,1,1,1,2020-03-03T14:28:54Z,2020-03-04T12:03:42Z,1,0,1,1,0,1,1,0,{'LD3': 1},1,0,{'LD3': 1},
18257,1,0.022222222,1,2020-03-04T07:58:21Z,2020-04-17T10:32:37Z,45,44,1,0.022222222,1,1,0,1,{},0,1,{},Wallet
18258,1,0.125,1,2020-03-04T14:33:44Z,2020-03-11T17:30:23Z,8,7,1,0.125,2,1,1,0,{'LD6': 1},1,0,{'LD6': 1},"Docs,good first issue"
18266,6,0.1,1.2,2020-03-05T07:07:25Z,2020-05-03T13:00:07Z,60,55,5,0.083333333,4,3,4,2,"{'LD6': 3, 'LD2': 1}",3,0,"{'LD6': 2, 'LD2': 1}","Tests,good first issue"
18281,4,0.047058824,2,2020-03-06T15:20:28Z,2020-05-30T13:32:25Z,85,83,2,0.023529412,2,1,2,2,{'LD3': 2},1,0,{'LD3': 1},Bug
18296,4,0.076923077,1.333333333,2020-03-08T10:45:34Z,2020-04-28T12:47:45Z,52,49,3,0.057692308,1,2,3,1,{'LD2': 3},2,0,{'LD2': 2},
18315,6,0.142857143,2,2020-03-11T14:20:30Z,2020-04-22T13:24:57Z,42,39,3,0.071428571,3,2,1,5,{'LD4': 1},1,1,{'LD4': 1},"Brainstorming,Bug,RPC/REST/ZMQ,Wallet"
18324,8,0.2,2,2020-03-11T22:36:33Z,2020-04-20T14:37:40Z,40,36,4,0.1,3,2,3,5,"{'LD4': 2, 'LD5': 1}",2,0,"{'LD4': 2, 'LD5': 1}","Bug,P2P"
18325,10,0.120481928,1.666666667,2020-03-11T22:46:24Z,2020-06-02T22:12:51Z,83,77,6,0.072289157,5,3,5,5,"{'LD4': 2, 'LD1': 1, 'LD2': 2}",3,0,"{'LD4': 2, 'LD1': 1, 'LD2': 2}","Bug,Wallet"
18348,10,0.092592593,2,2020-03-13T22:48:03Z,2020-06-29T15:47:22Z,108,103,5,0.046296296,3,2,4,6,"{'LD6': 1, 'LD4': 1, 'LD1': 2}",1,1,"{'LD6': 1, 'LD4': 1, 'LD1': 1}",Bug
18355,2,2,2,2020-03-15T18:25:43Z,2020-03-15T21:43:43Z,1,0,1,1,0,2,2,0,"{'LD4': 1, 'LD1': 1}",2,0,"{'LD4': 1, 'LD1': 1}",Questions and Help
18356,1,0.333333333,1,2020-03-15T19:04:42Z,2020-03-18T07:47:40Z,3,2,1,0.333333333,1,1,1,0,{'LD1': 1},1,0,{'LD1': 1},
18362,3,0.069767442,1,2020-03-16T18:53:23Z,2020-04-27T20:38:00Z,43,40,3,0.069767442,3,2,1,2,{'LD4': 1},1,1,{'LD4': 1},"Bug,GUI"
18373,5,0.555555556,5,2020-03-18T03:46:49Z,2020-03-26T08:22:35Z,9,8,1,0.111111111,1,2,4,1,"{'LD1': 1, 'LD5': 1, 'LD3': 2}",2,0,"{'LD1': 1, 'LD5': 1, 'LD3': 2}","Build system,good first issue"
18389,6,1.5,3,2020-03-20T00:29:17Z,2020-03-23T11:40:47Z,4,2,2,0.5,1,2,3,3,"{'LD2': 1, 'LD3': 1, 'LD4': 1}",2,0,"{'LD2': 1, 'LD3': 1, 'LD4': 1}","Bug,Tests"
18409,1,1,1,2020-03-23T14:01:45Z,2020-03-23T15:18:37Z,1,0,1,1,0,1,0,1,{},0,1,{},Bug
18411,1,0.25,1,2020-03-23T15:23:12Z,2020-03-26T16:35:47Z,4,3,1,0.25,1,1,1,0,{'LD6': 1},1,0,{'LD6': 1},
18435,5,0.016666667,1.666666667,2020-03-26T07:41:00Z,2021-01-19T22:45:48Z,300,297,3,0.01,2,3,4,1,"{'LD3': 2, 'LD1': 1, 'LD4': 1}",3,0,"{'LD3': 2, 'LD1': 1, 'LD4': 1}",Bug
18440,1,0.026315789,1,2020-03-26T15:38:19Z,2020-05-03T14:38:52Z,38,37,1,0.026315789,1,1,0,1,{},0,1,{},"Bug,Tests"
18456,5,0.192307692,1.25,2020-03-28T11:52:11Z,2020-04-22T13:09:54Z,26,22,4,0.153846154,3,3,3,2,"{'LD4': 2, 'LD1': 1}",2,1,"{'LD4': 2, 'LD1': 1}","Bug,Utils/log/libs"
18460,1,0.004524887,1,2020-03-28T22:43:31Z,2020-11-04T22:12:41Z,221,220,1,0.004524887,1,1,0,1,{},0,1,{},Bug
18465,6,0.461538462,2,2020-03-29T15:19:39Z,2020-04-10T16:54:01Z,13,10,3,0.230769231,2,2,3,3,{'LD3': 3},1,1,{'LD3': 1},Bug
18473,10,0.12987013,1.25,2020-03-30T19:35:31Z,2020-06-14T23:56:59Z,77,69,8,0.103896104,7,3,7,3,"{'LD6': 2, 'LD4': 4, 'LD5': 1}",2,1,"{'LD6': 2, 'LD4': 1, 'LD5': 1}",good first issue
18482,10,1.428571429,3.333333333,2020-03-31T10:53:59Z,2020-04-06T18:29:54Z,7,4,3,0.428571429,1,2,1,9,{'LD4': 1},1,1,{'LD4': 1},Bug
18483,10,0.5,3.333333333,2020-03-31T15:03:42Z,2020-04-20T11:02:16Z,20,17,3,0.15,1,5,2,8,"{'LD2': 1, 'LD4': 1}",2,3,"{'LD2': 1, 'LD4': 1}","Bug,P2P"
18497,1,0.037037037,1,2020-04-01T14:37:42Z,2020-04-28T12:49:05Z,27,26,1,0.037037037,1,1,1,0,{'LD2': 1},1,0,{'LD2': 1},Wallet
18511,1,0.25,1,2020-04-03T01:30:03Z,2020-04-06T15:39:23Z,4,3,1,0.25,1,1,0,1,{},0,1,{},Bug
18517,15,5,5,2020-04-03T16:05:54Z,2020-04-06T15:38:25Z,3,0,3,1,0,4,5,10,"{'LD4': 1, 'LD3': 4}",3,1,"{'LD4': 1, 'LD3': 2}",Bug
18527,1,1,1,2020-04-04T21:53:53Z,2020-04-05T02:35:07Z,1,0,1,1,0,1,0,1,{},0,1,{},"Build system,good first issue"
18538,8,0.060150376,1.6,2020-04-06T15:32:37Z,2020-08-16T22:06:08Z,133,128,5,0.037593985,5,2,3,5,"{'LD4': 2, 'LD3': 1}",1,1,"{'LD4': 1, 'LD3': 1}",
18547,2,0.090909091,1,2020-04-06T20:31:09Z,2020-04-28T08:44:30Z,22,20,2,0.090909091,2,2,0,2,{},0,2,{},Build system
18548,1,0.142857143,1,2020-04-06T20:33:06Z,2020-04-13T13:37:21Z,7,6,1,0.142857143,2,1,0,1,{},0,1,{},Bug
18602,3,0.025,1,2020-04-12T07:45:28Z,2020-08-10T07:01:53Z,120,117,3,0.025,3,3,0,3,{},0,3,{},"Bug,GUI"
18622,4,0.086956522,1.333333333,2020-04-13T13:28:11Z,2020-05-28T15:55:33Z,46,43,3,0.065217391,3,2,2,2,{'LD3': 2},2,0,{'LD3': 2},"Bug,Upstream,Windows"
18643,2,0.012987013,1,2020-04-15T01:17:12Z,2020-09-15T08:37:40Z,154,152,2,0.012987013,3,2,0,2,{},0,2,{},"Bug,GUI"
18651,1,1,1,2020-04-15T11:27:34Z,2020-04-15T11:39:33Z,1,0,1,1,0,1,0,1,{},0,1,{},Feature
18652,4,0.2,2,2020-04-15T12:45:51Z,2020-05-05T07:02:15Z,20,18,2,0.1,1,2,2,2,{'LD4': 2},2,0,{'LD4': 2},"Bug,Build system"
18658,1,0.076923077,1,2020-04-15T20:00:29Z,2020-04-28T12:52:55Z,13,12,1,0.076923077,1,1,0,1,{},0,1,{},Docs
18668,1,0.003546099,1,2020-04-16T14:58:13Z,2021-01-22T23:14:16Z,282,281,1,0.003546099,1,1,1,0,{'LD2': 1},1,0,{'LD2': 1},Data corruption
18678,4,0.222222222,1.333333333,2020-04-16T21:10:57Z,2020-05-04T14:05:02Z,18,15,3,0.166666667,3,2,3,1,"{'LD2': 1, 'LD3': 2}",2,0,"{'LD2': 1, 'LD3': 1}",Brainstorming
18684,8,2.666666667,8,2020-04-17T14:28:41Z,2020-04-20T10:16:13Z,3,2,1,0.333333333,1,2,4,4,"{'LD3': 3, 'LD4': 1}",2,0,"{'LD3': 2, 'LD4': 1}",Bug
18701,1,0.25,1,2020-04-19T02:25:03Z,2020-04-22T16:13:33Z,4,3,1,0.25,1,1,1,0,{'LD1': 1},1,0,{'LD1': 1},
18703,6,0.545454545,2,2020-04-19T11:58:04Z,2020-04-30T09:46:03Z,11,8,3,0.272727273,1,5,3,3,"{'LD4': 1, 'LD1': 1, 'LD3': 1}",3,2,"{'LD4': 1, 'LD1': 1, 'LD3': 1}","Bug,Docs,good first issue"
18706,2,0.666666667,2,2020-04-19T17:27:31Z,2020-04-22T13:25:20Z,3,2,1,0.333333333,1,1,0,2,{},0,1,{},Bug
18711,2,2,2,2020-04-20T16:58:20Z,2020-04-21T11:28:32Z,1,0,1,1,0,2,2,0,{'LD3': 2},2,0,{'LD3': 2},Bug
18749,5,2.5,2.5,2020-04-23T11:21:18Z,2020-04-24T18:40:55Z,2,0,2,1,0,3,2,3,"{'LD3': 1, 'LD2': 1}",2,1,"{'LD3': 1, 'LD2': 1}",Tests
18767,15,3.75,15,2020-04-25T17:23:52Z,2020-04-29T15:10:03Z,4,3,1,0.25,1,1,4,11,"{'LD6': 1, 'LD5': 1, 'LD3': 1, 'LD4': 1}",1,0,"{'LD6': 1, 'LD5': 1, 'LD3': 1, 'LD4': 1}",good first issue
18768,3,1,3,2020-04-25T17:38:22Z,2020-04-28T15:51:19Z,3,2,1,0.333333333,1,1,1,2,{'LD2': 1},1,0,{'LD2': 1},"Bug,Tests"
18773,1,1,1,2020-04-26T14:09:27Z,2020-04-26T14:35:15Z,1,0,1,1,0,1,1,0,{'LD4': 1},1,0,{'LD4': 1},Feature
18803,2,0.011695906,1,2020-04-28T13:00:53Z,2020-10-16T04:05:49Z,171,169,2,0.011695906,3,2,0,2,{},0,2,{},Bug
18804,1,0.012987013,1,2020-04-28T15:21:17Z,2020-07-14T07:58:12Z,77,76,1,0.012987013,2,1,1,0,{'LD3': 1},1,0,{'LD3': 1},"Refactoring,Utils/log/libs"
18811,3,0.2,3,2020-04-29T01:33:11Z,2020-05-13T09:36:18Z,15,14,1,0.066666667,1,1,0,3,{},0,1,{},Bug
18823,3,0.130434783,1.5,2020-04-30T03:46:57Z,2020-05-22T06:53:27Z,23,21,2,0.086956522,2,2,2,1,"{'LD4': 1, 'LD1': 1}",1,1,"{'LD4': 1, 'LD1': 1}",Bug
18824,1,0.037037037,1,2020-04-30T07:28:15Z,2020-05-26T12:17:07Z,27,26,1,0.037037037,1,1,0,1,{},0,1,{},
18835,13,0.060185185,1.857142857,2020-04-30T17:59:42Z,2020-12-02T09:52:27Z,216,209,7,0.032407407,4,3,4,9,"{'LD4': 2, 'LD2': 1, 'LD5': 1}",3,0,"{'LD4': 1, 'LD2': 1, 'LD5': 1}",GUI
18845,2,2,2,2020-05-01T22:38:00Z,2020-05-02T08:05:03Z,1,0,1,1,0,2,1,1,{'LD2': 1},1,1,{'LD2': 1},Feature
18846,1,1,1,2020-05-01T23:51:19Z,2020-05-01T23:57:20Z,1,0,1,1,0,1,1,0,{'LD1': 1},1,0,{'LD1': 1},
18852,4,4,4,2020-05-02T16:20:42Z,2020-05-03T12:17:58Z,1,0,1,1,0,3,1,3,{'LD4': 1},1,2,{'LD4': 1},
18858,1,1,1,2020-05-03T17:43:04Z,2020-05-04T11:50:06Z,1,0,1,1,0,1,0,1,{},0,1,{},Tests
18860,4,4,4,2020-05-03T21:16:50Z,2020-05-03T21:36:40Z,1,0,1,1,0,3,2,2,"{'LD1': 1, 'LD5': 1}",2,1,"{'LD1': 1, 'LD5': 1}",
18868,1,0.333333333,1,2020-05-04T15:08:04Z,2020-05-07T14:28:36Z,3,2,1,0.333333333,1,1,0,1,{},0,1,{},"Bug,Tests"
18869,2,2,2,2020-05-04T17:45:25Z,2020-05-04T20:06:37Z,1,0,1,1,0,1,2,0,{'LD4': 2},1,0,{'LD4': 1},"Bug,Build system,Linux/Unix"
18874,1,1,1,2020-05-04T23:55:14Z,2020-05-05T00:58:42Z,1,0,1,1,0,1,0,1,{},0,1,{},Bug
18884,1,0.00621118,1,2020-05-05T09:45:42Z,2020-10-12T12:20:51Z,161,160,1,0.00621118,1,1,1,0,{'LD5': 1},1,0,{'LD5': 1},"Feature,P2P"
18913,1,0.005464481,1,2020-05-08T05:21:59Z,2020-11-06T11:07:06Z,183,182,1,0.005464481,1,1,0,1,{},0,1,{},Tests
18915,1,0.005780347,1,2020-05-08T14:12:50Z,2020-10-27T18:19:03Z,173,172,1,0.005780347,2,1,1,0,{'LD6': 1},1,0,{'LD6': 1},"Bug,Build system"
18916,27,0.16875,3.375,2020-05-08T16:25:36Z,2020-10-15T07:19:06Z,160,152,8,0.05,4,11,9,18,"{'LD6': 1, 'LD5': 2, 'LD3': 2, 'LD4': 1, 'LD1': 2, 'LD2': 1}",6,5,"{'LD6': 1, 'LD5': 2, 'LD3': 2, 'LD4': 1, 'LD1': 2, 'LD2': 1}","Feature,Wallet"
18924,1,0.25,1,2020-05-09T14:05:08Z,2020-05-13T13:13:48Z,4,3,1,0.25,1,1,0,1,{},0,1,{},Bug
18930,14,0.325581395,4.666666667,2020-05-10T12:56:12Z,2020-06-21T13:18:24Z,43,40,3,0.069767442,2,11,6,8,"{'LD4': 1, 'LD6': 2, 'LD3': 2, 'LD1': 1}",5,6,"{'LD4': 1, 'LD6': 2, 'LD3': 2, 'LD1': 1}","Tests,good first issue"
18934,1,0.003597122,1,2020-05-10T14:39:21Z,2021-02-12T06:53:45Z,278,277,1,0.003597122,2,1,0,1,{},0,1,{},Bug
18947,7,0.028,1.4,2020-05-11T14:35:29Z,2021-01-15T19:49:19Z,250,245,5,0.02,5,4,0,7,{},0,4,{},
18950,5,0.034722222,1.666666667,2020-05-11T15:47:42Z,2020-10-01T21:23:43Z,144,141,3,0.020833333,1,2,1,4,{'LD4': 1},1,1,{'LD4': 1},"RPC/REST/ZMQ,Upstream"
18966,5,0.227272727,1.25,2020-05-13T06:53:00Z,2020-06-04T02:44:57Z,22,18,4,0.181818182,2,2,1,4,{'LD6': 1},1,1,{'LD6': 1},"Build system,good first issue"
18979,2,0.4,2,2020-05-15T05:52:29Z,2020-05-19T17:53:05Z,5,4,1,0.2,1,2,0,2,{},0,2,{},Tests
18995,10,0.133333333,2.5,2020-05-17T11:30:59Z,2020-07-31T01:28:06Z,75,71,4,0.053333333,2,3,1,9,{'LD6': 1},1,2,{'LD6': 1},"Docs,P2P,good first issue"
18998,1,1,1,2020-05-17T15:43:42Z,2020-05-17T18:06:13Z,1,0,1,1,0,1,0,1,{},0,1,{},
19000,3,0.3,3,2020-05-17T20:33:27Z,2020-05-27T11:18:39Z,10,9,1,0.1,1,2,0,3,{},0,2,{},good first issue
19016,4,0.017316017,2,2020-05-19T13:37:43Z,2021-01-05T09:37:39Z,231,229,2,0.008658009,1,3,3,1,"{'LD4': 2, 'LD6': 1}",3,0,"{'LD4': 2, 'LD6': 1}",Bug
19017,7,0.4375,2.333333333,2020-05-19T14:33:10Z,2020-06-04T14:28:15Z,16,13,3,0.1875,2,4,2,5,{'LD4': 2},2,2,{'LD4': 2},"Refactoring,good first issue"
19021,1,1,1,2020-05-19T22:05:43Z,2020-05-19T23:19:35Z,1,0,1,1,0,1,1,0,{'LD3': 1},1,0,{'LD3': 1},"Brainstorming,Wallet"
19024,20,1.666666667,6.666666667,2020-05-19T23:46:21Z,2020-05-31T14:36:44Z,12,9,3,0.25,1,3,5,15,"{'LD3': 4, 'LD4': 1}",2,1,"{'LD3': 2, 'LD4': 1}",Bug
19037,1,0.038461538,1,2020-05-21T12:28:08Z,2020-06-16T11:27:24Z,26,25,1,0.038461538,2,1,0,1,{},0,1,{},"Tests,good first issue"
19047,10,0.833333333,5,2020-05-22T06:51:31Z,2020-06-02T09:49:47Z,12,10,2,0.166666667,1,2,4,6,{'LD4': 4},2,0,{'LD4': 2},Tests
19049,19,0.093596059,3.8,2020-05-22T10:29:17Z,2020-12-11T01:45:51Z,203,198,5,0.024630542,3,3,6,13,"{'LD4': 4, 'LD3': 1, 'LD6': 1}",3,0,"{'LD4': 2, 'LD3': 1, 'LD6': 1}",Bug
19051,2,0.068965517,2,2020-05-22T14:47:53Z,2020-06-19T20:15:37Z,29,28,1,0.034482759,1,1,1,1,{'LD4': 1},1,0,{'LD4': 1},"Bug,Wallet"
19057,1,0.008333333,1,2020-05-22T20:54:28Z,2020-09-19T07:04:17Z,120,119,1,0.008333333,1,1,1,0,{'LD4': 1},1,0,{'LD4': 1},good first issue
19066,1,0.25,1,2020-05-25T03:56:08Z,2020-05-28T12:16:08Z,4,3,1,0.25,1,1,0,1,{},0,1,{},Bug
19079,1,0.007092199,1,2020-05-27T12:47:02Z,2020-10-14T21:05:47Z,141,140,1,0.007092199,1,1,1,0,{'LD5': 1},1,0,{'LD5': 1},"Bug,Wallet"
19080,5,0.054347826,1.666666667,2020-05-27T14:31:58Z,2020-08-27T06:24:48Z,92,89,3,0.032608696,2,3,2,3,{'LD6': 2},2,1,{'LD6': 2},good first issue
19091,4,0.0625,1.333333333,2020-05-28T15:06:19Z,2020-07-30T15:51:36Z,64,61,3,0.046875,3,4,4,0,"{'LD6': 3, 'LD5': 1}",4,0,"{'LD6': 3, 'LD5': 1}",good first issue
19103,3,0.038461538,3,2020-05-29T07:55:36Z,2020-08-14T09:55:24Z,78,77,1,0.012820513,1,2,0,3,{},0,2,{},"Bug,GUI"
19113,2,0.013245033,2,2020-05-30T07:28:05Z,2020-10-27T09:23:52Z,151,150,1,0.006622517,2,1,2,0,{'LD6': 2},1,0,{'LD6': 1},Docs
19141,1,1,1,2020-06-02T12:06:08Z,2020-06-02T12:20:47Z,1,0,1,1,0,1,1,0,{'LD2': 1},1,0,{'LD2': 1},Bug
19150,1,1,1,2020-06-03T05:21:19Z,2020-06-03T09:55:59Z,1,0,1,1,0,1,1,0,{'LD4': 1},1,0,{'LD4': 1},TX fees and policy
19165,3,0.428571429,1.5,2020-06-04T07:23:26Z,2020-06-10T12:08:55Z,7,5,2,0.285714286,2,3,2,1,"{'LD4': 1, 'LD5': 1}",2,1,"{'LD4': 1, 'LD5': 1}",
19167,1,0.014285714,1,2020-06-04T14:14:04Z,2020-08-13T07:26:19Z,70,69,1,0.014285714,2,1,1,0,{'LD4': 1},1,0,{'LD4': 1},"Bug,macOS"
19171,2,0.181818182,1,2020-06-05T04:51:47Z,2020-06-15T10:27:00Z,11,9,2,0.181818182,2,2,0,2,{},0,2,{},"Bug,Tests"
19186,2,0.030769231,1,2020-06-06T11:15:09Z,2020-08-10T06:52:43Z,65,63,2,0.030769231,2,2,2,0,{'LD4': 2},2,0,{'LD4': 2},"Bug,GUI"
19199,2,2,2,2020-06-07T13:52:07Z,2020-06-07T19:39:03Z,1,0,1,1,0,2,1,1,{'LD3': 1},1,1,{'LD3': 1},Bug
19209,3,3,3,2020-06-08T13:03:41Z,2020-06-08T14:35:09Z,1,0,1,1,0,2,1,2,{'LD5': 1},1,1,{'LD5': 1},Linux/Unix
19211,1,0.5,1,2020-06-08T14:41:37Z,2020-06-10T13:25:34Z,2,1,1,0.5,1,1,0,1,{},0,1,{},Bug
19218,1,0.5,1,2020-06-09T05:37:29Z,2020-06-10T07:21:56Z,2,1,1,0.5,1,1,0,1,{},0,1,{},
19223,3,0.012658228,1,2020-06-09T13:30:48Z,2021-02-01T09:57:08Z,237,234,3,0.012658228,3,3,1,2,{'LD3': 1},1,2,{'LD3': 1},
19232,11,0.55,2.75,2020-06-10T09:05:26Z,2020-06-29T15:57:17Z,20,16,4,0.2,2,3,7,4,"{'LD4': 2, 'LD1': 4, 'LD3': 1}",2,1,"{'LD4': 2, 'LD1': 2, 'LD3': 1}","Bug,Wallet"
19235,2,0.125,2,2020-06-10T11:27:45Z,2020-06-25T12:08:50Z,16,15,1,0.0625,1,2,0,2,{},0,2,{},Bug
19244,3,3,3,2020-06-11T08:33:25Z,2020-06-11T16:22:58Z,1,0,1,1,0,2,1,2,{'LD5': 1},1,1,{'LD5': 1},"Feature,Utils/log/libs,Wallet"
19254,2,0.060606061,1,2020-06-11T18:50:56Z,2020-07-14T07:32:07Z,33,31,2,0.060606061,1,2,0,2,{},0,2,{},"Brainstorming,Bug,P2P"
19255,1,0.03030303,1,2020-06-12T03:46:53Z,2020-07-14T14:35:06Z,33,32,1,0.03030303,1,1,0,1,{},0,1,{},"Bug,GUI"
19311,1,1,1,2020-06-17T17:04:19Z,2020-06-17T18:47:49Z,1,0,1,1,0,1,0,1,{},0,1,{},Bug
19329,3,3,3,2020-06-19T19:30:54Z,2020-06-20T11:06:44Z,1,0,1,1,0,2,0,3,{},0,2,{},Bug
19336,2,0.009950249,1,2020-06-20T08:23:38Z,2021-01-06T12:43:54Z,201,199,2,0.009950249,2,1,0,2,{},0,1,{},"Tests,Upstream"
19338,4,0.444444444,1,2020-06-20T16:45:14Z,2020-06-29T14:49:46Z,9,5,4,0.444444444,1,2,4,0,"{'LD3': 2, 'LD4': 1, 'LD2': 1}",2,0,"{'LD3': 2, 'LD4': 1, 'LD2': 1}",Bug
19343,1,0.071428571,1,2020-06-21T06:53:16Z,2020-07-05T06:48:42Z,14,13,1,0.071428571,1,1,0,1,{},0,1,{},Bug
19345,1,0.5,1,2020-06-21T13:19:49Z,2020-06-22T16:27:57Z,2,1,1,0.5,1,1,1,0,{'LD6': 1},1,0,{'LD6': 1},"Tests,good first issue"
19346,1,0.2,1,2020-06-21T13:22:58Z,2020-06-25T15:09:58Z,5,4,1,0.2,1,1,1,0,{'LD6': 1},1,0,{'LD6': 1},"Tests,good first issue"
19352,1,0.25,1,2020-06-22T14:06:01Z,2020-06-25T15:02:54Z,4,3,1,0.25,1,1,0,1,{},0,1,{},Bug
19376,1,1,1,2020-06-25T06:09:18Z,2020-06-25T15:26:50Z,1,0,1,1,0,1,1,0,{'LD2': 1},1,0,{'LD2': 1},Bug
19380,2,0.666666667,1,2020-06-25T16:54:34Z,2020-06-28T12:32:01Z,3,1,2,0.666666667,1,1,1,1,{'LD4': 1},1,0,{'LD4': 1},Bug
19388,18,0.079295154,2.25,2020-06-26T18:42:12Z,2021-02-08T09:08:23Z,227,219,8,0.035242291,6,5,7,11,"{'LD4': 4, 'LD6': 3}",4,1,"{'LD4': 3, 'LD6': 2}","Build system,Tests,good first issue"
19392,2,2,2,2020-06-27T10:16:45Z,2020-06-27T19:42:39Z,1,0,1,1,0,1,0,2,{},0,1,{},Feature
19402,1,1,1,2020-06-28T20:42:59Z,2020-06-29T13:49:18Z,1,0,1,1,0,1,0,1,{},0,1,{},"Bug,Build system"
19404,1,0.02173913,1,2020-06-29T06:07:13Z,2020-08-13T07:24:45Z,46,45,1,0.02173913,2,1,1,0,{'LD4': 1},1,0,{'LD4': 1},"Bug,macOS"
19406,2,0.010416667,1,2020-06-29T11:51:26Z,2021-01-06T12:34:34Z,192,190,2,0.010416667,2,2,0,2,{},0,2,{},macOS
19409,1,1,1,2020-06-29T12:48:33Z,2020-06-29T14:15:38Z,1,0,1,1,0,1,0,1,{},0,1,{},Bug
19410,2,0.666666667,2,2020-06-29T13:25:03Z,2020-07-01T19:15:27Z,3,2,1,0.333333333,1,1,1,1,{'LD2': 1},1,0,{'LD2': 1},Bug
19411,20,0.163934426,1.666666667,2020-06-29T13:44:59Z,2020-10-29T11:32:17Z,122,110,12,0.098360656,8,6,7,13,"{'LD4': 2, 'LD3': 3, 'LD1': 1, 'LD6': 1}",5,1,"{'LD4': 1, 'LD3': 3, 'LD1': 1, 'LD6': 1}","Bug,macOS"
19417,1,0.333333333,1,2020-06-30T06:36:33Z,2020-07-02T14:23:02Z,3,2,1,0.333333333,2,1,0,1,{},0,1,{},"Bug,Wallet"
19440,2,0.4,2,2020-07-03T23:27:44Z,2020-07-08T15:54:38Z,5,4,1,0.2,1,1,0,2,{},0,1,{},"Bug,Tests,Upstream,Windows"
19446,2,2,2,2020-07-04T17:00:49Z,2020-07-04T18:20:30Z,1,0,1,1,0,1,1,1,{'LD4': 1},1,0,{'LD4': 1},"Questions and Help,Wallet"
19449,1,0.005154639,1,2020-07-05T14:57:09Z,2021-01-14T15:01:35Z,194,193,1,0.005154639,1,1,1,0,{'LD5': 1},1,0,{'LD5': 1},Bug
19456,6,6,6,2020-07-06T14:12:38Z,2020-07-07T09:43:02Z,1,0,1,1,0,2,3,3,"{'LD5': 2, 'LD1': 1}",1,1,"{'LD5': 1, 'LD1': 1}",Bug
19458,1,1,1,2020-07-07T08:45:44Z,2020-07-07T10:54:47Z,1,0,1,1,0,1,1,0,{'LD6': 1},1,0,{'LD6': 1},P2P
19487,2,0.066666667,1,2020-07-11T03:21:07Z,2020-08-10T02:59:39Z,30,28,2,0.066666667,3,1,0,2,{},0,1,{},"Block storage,Feature"
19500,8,0.150943396,2.666666667,2020-07-12T18:05:31Z,2020-09-03T15:21:26Z,53,50,3,0.056603774,3,2,1,7,{'LD2': 1},1,1,{'LD2': 1},Feature
19510,3,0.096774194,3,2020-07-14T05:29:13Z,2020-08-13T07:23:53Z,31,30,1,0.032258065,1,1,1,2,{'LD4': 1},1,0,{'LD4': 1},macOS
19511,1,0.058823529,1,2020-07-14T08:00:03Z,2020-07-30T15:10:00Z,17,16,1,0.058823529,1,1,1,0,{'LD6': 1},1,0,{'LD6': 1},good first issue
19516,1,1,1,2020-07-14T15:53:19Z,2020-07-15T04:01:21Z,1,0,1,1,0,1,0,1,{},0,1,{},Bug
19523,1,0.0625,1,2020-07-15T04:05:47Z,2020-07-30T07:47:01Z,16,15,1,0.0625,2,1,0,1,{},0,1,{},"Tests,good first issue"
19527,2,2,2,2020-07-15T17:02:33Z,2020-07-15T18:06:19Z,1,0,1,1,0,2,2,0,"{'LD4': 1, 'LD1': 1}",2,0,"{'LD4': 1, 'LD1': 1}",
19543,15,0.12195122,1.875,2020-07-17T15:17:15Z,2020-11-17T12:52:24Z,123,115,8,0.06504065,6,4,5,10,"{'LD6': 2, 'LD2': 1, 'LD3': 2}",3,1,"{'LD6': 2, 'LD2': 1, 'LD3': 2}","Feature,RPC/REST/ZMQ"
19549,1,1,1,2020-07-18T19:28:54Z,2020-07-19T11:26:15Z,1,0,1,1,0,1,0,1,{},0,1,{},"Bug,Tests"
19557,3,1,3,2020-07-20T03:48:02Z,2020-07-22T10:04:24Z,3,2,1,0.333333333,2,3,3,0,"{'LD6': 1, 'LD4': 1, 'LD1': 1}",3,0,"{'LD6': 1, 'LD4': 1, 'LD1': 1}","Tests,good first issue,macOS"
19566,3,3,3,2020-07-22T10:59:07Z,2020-07-22T11:45:18Z,1,0,1,1,0,2,2,1,"{'LD4': 1, 'LD1': 1}",2,0,"{'LD4': 1, 'LD1': 1}",Bug
19570,6,6,6,2020-07-23T07:41:01Z,2020-07-23T19:00:24Z,1,0,1,1,0,2,4,2,"{'LD4': 3, 'LD1': 1}",2,0,"{'LD4': 2, 'LD1': 1}",Feature
19571,6,0.083333333,3,2020-07-23T08:16:26Z,2020-10-02T11:55:30Z,72,70,2,0.027777778,2,2,4,2,"{'LD4': 1, 'LD1': 2, 'LD2': 1}",2,0,"{'LD4': 1, 'LD1': 2, 'LD2': 1}",Bug
19579,1,0.142857143,1,2020-07-24T12:00:56Z,2020-07-31T05:53:38Z,7,6,1,0.142857143,1,1,0,1,{},0,1,{},
19581,1,1,1,2020-07-24T13:52:35Z,2020-07-24T14:45:55Z,1,0,1,1,0,1,0,1,{},0,1,{},Feature
19582,1,0.111111111,1,2020-07-24T15:36:39Z,2020-08-02T10:45:29Z,9,8,1,0.111111111,1,1,1,0,{'LD6': 1},1,0,{'LD6': 1},good first issue
19587,2,0.012121212,1,2020-07-24T23:35:20Z,2021-01-04T23:50:14Z,165,163,2,0.012121212,3,2,0,2,{},0,2,{},"Bug,RPC/REST/ZMQ,Wallet"
19598,3,0.053571429,1.5,2020-07-27T11:40:09Z,2020-09-20T13:19:30Z,56,54,2,0.035714286,2,2,1,2,{'LD3': 1},1,1,{'LD3': 1},Feature
19603,2,0.03125,1,2020-07-27T23:59:30Z,2020-09-29T12:41:26Z,64,62,2,0.03125,3,2,1,1,{'LD2': 1},1,1,{'LD2': 1},"Feature,Utils/log/libs"
19616,3,3,3,2020-07-28T21:13:18Z,2020-07-29T09:23:08Z,1,0,1,1,0,2,1,2,{'LD3': 1},1,1,{'LD3': 1},RPC/REST/ZMQ
19618,2,0.0125,1,2020-07-29T11:15:58Z,2021-01-05T00:14:50Z,160,158,2,0.0125,1,2,1,1,{'LD2': 1},1,1,{'LD2': 1},"Bug,P2P"
19625,3,0.1,1.5,2020-07-30T10:29:51Z,2020-08-28T13:24:40Z,30,28,2,0.066666667,2,1,0,3,{},0,1,{},"Docs,RPC/REST/ZMQ"
19633,5,5,5,2020-07-31T07:56:39Z,2020-07-31T16:24:21Z,1,0,1,1,0,2,3,2,{'LD1': 3},2,0,{'LD1': 2},"Build system,Linux/Unix,Questions and Help"
19641,3,0.017964072,1,2020-08-02T09:09:52Z,2021-01-15T19:16:09Z,167,164,3,0.017964072,3,3,1,2,{'LD5': 1},1,2,{'LD5': 1},Feature
19648,1,1,1,2020-08-02T23:44:56Z,2020-08-03T00:06:32Z,1,0,1,1,0,1,0,1,{},0,1,{},Bug
19650,4,0.266666667,2,2020-08-03T07:16:44Z,2020-08-17T09:11:37Z,15,13,2,0.133333333,1,2,1,3,{'LD4': 1},1,1,{'LD4': 1},Bug
19662,4,0.024242424,2,2020-08-04T18:11:32Z,2021-01-15T19:17:01Z,165,163,2,0.012121212,2,2,2,2,"{'LD1': 1, 'LD5': 1}",1,1,"{'LD1': 1, 'LD5': 1}","Feature,Wallet"
19666,4,4,4,2020-08-05T03:49:02Z,2020-08-05T06:54:47Z,1,0,1,1,0,3,1,3,{'LD3': 1},1,2,{'LD3': 1},"Feature,Tests"
19676,1,0.007936508,1,2020-08-06T22:26:26Z,2020-12-10T07:27:05Z,126,125,1,0.007936508,2,1,0,1,{},0,1,{},"Feature,P2P"
19678,2,0.071428571,1,2020-08-07T07:20:28Z,2020-09-03T15:24:18Z,28,26,2,0.071428571,3,2,0,2,{},0,2,{},Tests
19679,2,1,2,2020-08-07T11:22:05Z,2020-08-09T07:16:52Z,2,1,1,0.5,1,2,0,2,{},0,2,{},Tests
19692,1,1,1,2020-08-10T05:39:36Z,2020-08-10T06:56:33Z,1,0,1,1,0,1,1,0,{'LD1': 1},1,0,{'LD1': 1},"Bug,Windows"
19693,17,1.133333333,8.5,2020-08-10T13:19:41Z,2020-08-25T12:36:58Z,15,13,2,0.133333333,1,11,3,14,"{'LD4': 1, 'LD2': 1, 'LD6': 1}",2,9,"{'LD4': 1, 'LD2': 1, 'LD6': 1}","Build system,Feature"
19701,2,1,1,2020-08-12T05:29:49Z,2020-08-13T16:24:42Z,2,0,2,1,0,2,1,1,{'LD6': 1},1,1,{'LD6': 1},"Bug,Tests"
19702,7,0.047619048,2.333333333,2020-08-12T09:25:30Z,2021-01-05T11:08:57Z,147,144,3,0.020408163,3,3,4,3,"{'LD6': 3, 'LD3': 1}",2,1,"{'LD6': 2, 'LD3': 1}","Build system,good first issue"
19703,2,0.1,2,2020-08-12T11:17:56Z,2020-08-31T11:50:04Z,20,19,1,0.05,2,1,2,0,{'LD4': 2},1,0,{'LD4': 1},Bug
19712,2,0.111111111,1,2020-08-13T16:59:13Z,2020-08-31T01:59:40Z,18,16,2,0.111111111,3,1,0,2,{},0,1,{},Bug
19715,1,1,1,2020-08-14T07:07:26Z,2020-08-14T07:35:36Z,1,0,1,1,0,1,0,1,{},0,1,{},
19729,1,1,1,2020-08-15T06:11:46Z,2020-08-15T13:41:04Z,1,0,1,1,0,1,1,0,{'LD2': 1},1,0,{'LD2': 1},Bug
19737,2,0.017094017,2,2020-08-16T22:37:11Z,2020-12-11T07:39:31Z,117,116,1,0.008547009,1,2,1,1,{'LD2': 1},1,1,{'LD2': 1},"Bug,Wallet"
19742,1,1,1,2020-08-17T05:31:27Z,2020-08-17T07:16:30Z,1,0,1,1,0,1,0,1,{},0,1,{},Bug
19744,1,0.333333333,1,2020-08-17T07:59:39Z,2020-08-19T08:14:55Z,3,2,1,0.333333333,1,1,1,0,{'LD1': 1},1,0,{'LD1': 1},Bug
19749,4,4,4,2020-08-17T14:40:36Z,2020-08-18T06:20:38Z,1,0,1,1,0,4,0,4,{},0,4,{},Bug
19766,1,0.5,1,2020-08-20T04:55:42Z,2020-08-21T14:45:17Z,2,1,1,0.5,1,1,0,1,{},0,1,{},"Bug,Docs,RPC/REST/ZMQ"
19787,10,5,5,2020-08-24T13:47:23Z,2020-08-26T05:46:28Z,2,0,2,1,0,4,3,7,"{'LD1': 1, 'LD2': 1, 'LD3': 1}",2,2,"{'LD1': 1, 'LD2': 1, 'LD3': 1}",
19798,2,2,2,2020-08-25T06:02:14Z,2020-08-25T06:23:34Z,1,0,1,1,0,1,0,2,{},0,1,{},
19799,2,0.066666667,1,2020-08-25T11:48:40Z,2020-09-23T18:30:46Z,30,28,2,0.066666667,2,1,1,1,{'LD4': 1},1,0,{'LD4': 1},Bug
19810,6,6,6,2020-08-26T01:38:38Z,2020-08-27T00:40:04Z,1,0,1,1,0,3,3,3,"{'LD4': 2, 'LD1': 1}",2,1,"{'LD4': 2, 'LD1': 1}","Feature,Waiting for author"
19811,3,0.02238806,1.5,2020-08-26T05:03:36Z,2021-01-07T01:36:03Z,134,132,2,0.014925373,1,2,0,3,{},0,2,{},Tests
19812,3,0.5,3,2020-08-26T08:58:35Z,2020-08-31T14:21:03Z,6,5,1,0.166666667,1,1,0,3,{},0,1,{},"Bug,Tests"
19819,3,0.25,1.5,2020-08-27T11:03:24Z,2020-09-07T18:15:17Z,12,10,2,0.166666667,2,3,2,1,"{'LD2': 1, 'LD1': 1}",2,1,"{'LD2': 1, 'LD1': 1}","Feature,RPC/REST/ZMQ"
19821,4,0.072727273,1.333333333,2020-08-27T16:02:25Z,2020-10-21T12:45:14Z,55,52,3,0.054545455,3,3,0,4,{},0,3,{},good first issue
19837,1,0.5,1,2020-08-30T08:56:10Z,2020-09-01T07:00:32Z,2,1,1,0.5,1,1,0,1,{},0,1,{},Bug
19838,1,0.083333333,1,2020-08-30T10:07:02Z,2020-09-10T10:41:36Z,12,11,1,0.083333333,2,1,1,0,{'LD6': 1},1,0,{'LD6': 1},good first issue
19853,6,1,2,2020-09-01T03:27:20Z,2020-09-06T11:06:37Z,6,3,3,0.5,2,5,1,5,{'LD3': 1},1,4,{'LD3': 1},Tests
19862,1,1,1,2020-09-03T17:22:28Z,2020-09-03T22:27:07Z,1,0,1,1,0,1,0,1,{},0,1,{},
19863,1,0.034482759,1,2020-09-03T21:47:53Z,2020-10-02T14:42:49Z,29,28,1,0.034482759,1,1,0,1,{},0,1,{},Bug
19864,1,0.333333333,1,2020-09-03T22:42:24Z,2020-09-06T05:52:28Z,3,2,1,0.333333333,2,1,0,1,{},0,1,{},Bug
19892,3,3,3,2020-09-06T11:47:30Z,2020-09-06T16:04:44Z,1,0,1,1,0,2,0,3,{},0,2,{},Questions and Help
19899,2,2,2,2020-09-06T17:50:34Z,2020-09-07T14:48:02Z,1,0,1,1,0,2,1,1,{'LD3': 1},1,1,{'LD3': 1},
19912,6,0.142857143,1.5,2020-09-07T20:54:36Z,2020-10-19T03:07:22Z,42,38,4,0.095238095,3,5,1,5,{'LD2': 1},1,4,{'LD2': 1},Bug
19921,6,3,3,2020-09-09T02:55:06Z,2020-09-10T18:19:10Z,2,0,2,1,0,5,2,4,"{'LD4': 1, 'LD3': 1}",2,3,"{'LD4': 1, 'LD3': 1}","Feature,Resource usage,Wallet"
19924,2,0.02,1,2020-09-09T09:26:44Z,2020-12-17T10:40:29Z,100,98,2,0.02,3,2,1,1,{'LD1': 1},1,1,{'LD1': 1},Feature
19928,2,0.037037037,1,2020-09-09T18:57:00Z,2020-11-01T22:42:08Z,54,52,2,0.037037037,2,2,1,1,{'LD3': 1},1,1,{'LD3': 1},Bug
19930,1,0.2,1,2020-09-10T05:54:05Z,2020-09-14T08:30:40Z,5,4,1,0.2,1,1,0,1,{},0,1,{},Bug
19941,7,0.318181818,1.75,2020-09-11T14:14:49Z,2020-10-02T21:16:39Z,22,18,4,0.181818182,3,4,4,3,{'LD3': 4},3,1,{'LD3': 3},"Brainstorming,Feature,Good First Review"
19943,3,0.6,3,2020-09-11T17:04:40Z,2020-09-16T12:14:51Z,5,4,1,0.2,1,1,1,2,{'LD1': 1},1,0,{'LD1': 1},Bug
19964,2,0.125,1,2020-09-16T14:45:58Z,2020-10-02T09:46:07Z,16,14,2,0.125,2,2,2,0,"{'LD1': 1, 'LD4': 1}",2,0,"{'LD1': 1, 'LD4': 1}",Bug
19966,3,0.032967033,1,2020-09-17T05:13:55Z,2020-12-16T12:33:40Z,91,88,3,0.032967033,2,3,3,0,{'LD3': 3},3,0,{'LD3': 3},Tests
19981,3,0.5,1.5,2020-09-20T04:58:01Z,2020-09-25T13:15:46Z,6,4,2,0.333333333,2,1,2,1,{'LD5': 2},1,0,{'LD5': 1},
20007,1,1,1,2020-09-24T03:53:37Z,2020-09-24T07:18:27Z,1,0,1,1,0,1,1,0,{'LD1': 1},1,0,{'LD1': 1},Questions and Help
20011,4,0.142857143,1.333333333,2020-09-25T07:03:16Z,2020-10-22T08:15:42Z,28,25,3,0.107142857,2,3,3,1,"{'LD3': 1, 'LD1': 1, 'LD4': 1}",3,0,"{'LD3': 1, 'LD1': 1, 'LD4': 1}",good first issue
20020,2,2,2,2020-09-25T20:49:44Z,2020-09-25T21:01:22Z,1,0,1,1,0,1,0,2,{},0,1,{},Feature
20021,5,5,5,2020-09-26T08:32:47Z,2020-09-26T11:05:13Z,1,0,1,1,0,1,3,2,"{'LD4': 2, 'LD3': 1}",1,0,"{'LD4': 1, 'LD3': 1}",Bug
20031,5,0.098039216,1.25,2020-09-29T06:43:52Z,2020-11-18T10:26:23Z,51,47,4,0.078431373,3,4,3,2,"{'LD2': 2, 'LD4': 1}",3,1,"{'LD2': 2, 'LD4': 1}","Build system,Windows"
20049,3,0.2,1,2020-09-30T19:37:56Z,2020-10-15T18:29:32Z,15,12,3,0.2,1,1,1,2,{'LD6': 1},1,0,{'LD6': 1},"Brainstorming,Needs Conceptual Review,Refactoring"
20051,1,1,1,2020-10-01T11:24:32Z,2020-10-01T11:30:49Z,1,0,1,1,0,1,0,1,{},0,1,{},Bug
20052,11,2.2,2.2,2020-10-01T11:59:21Z,2020-10-05T18:08:38Z,5,0,5,1,0,4,1,10,{'LD4': 1},1,3,{'LD4': 1},"Bug,Windows"
20053,2,2,2,2020-10-01T13:27:06Z,2020-10-01T13:40:36Z,1,0,1,1,0,1,2,0,"{'LD2': 1, 'LD5': 1}",1,0,"{'LD2': 1, 'LD5': 1}",Bug
20057,1,0.333333333,1,2020-10-01T17:29:22Z,2020-10-03T20:56:15Z,3,2,1,0.333333333,2,1,0,1,{},0,1,{},Bug
20062,3,0.0625,1,2020-10-02T09:33:07Z,2020-11-18T13:44:24Z,48,45,3,0.0625,3,2,0,3,{},0,2,{},
20066,13,3.25,4.333333333,2020-10-03T09:21:24Z,2020-10-07T09:00:39Z,4,1,3,0.75,1,5,3,10,"{'LD2': 1, 'LD4': 1, 'LD5': 1}",3,2,"{'LD2': 1, 'LD4': 1, 'LD5': 1}",Bug
20084,2,1,2,2020-10-05T15:21:29Z,2020-10-07T01:43:01Z,2,1,1,0.5,1,2,1,1,{'LD4': 1},1,1,{'LD4': 1},
20085,1,1,1,2020-10-05T15:21:45Z,2020-10-05T18:10:13Z,1,0,1,1,0,1,0,1,{},0,1,{},
20088,3,0.041666667,1,2020-10-05T17:30:37Z,2020-12-15T18:03:15Z,72,69,3,0.041666667,2,3,2,1,"{'LD4': 1, 'LD2': 1}",2,1,"{'LD4': 1, 'LD2': 1}","Brainstorming,Feature,Tests"
20093,1,0.333333333,1,2020-10-06T14:18:18Z,2020-10-09T06:46:11Z,3,2,1,0.333333333,2,1,0,1,{},0,1,{},"Bug,Tests"
20098,1,0.5,1,2020-10-07T12:33:31Z,2020-10-09T09:09:14Z,2,1,1,0.5,1,1,0,1,{},0,1,{},Feature
20099,2,0.02173913,2,2020-10-07T13:17:27Z,2021-01-07T00:41:59Z,92,91,1,0.010869565,1,2,0,2,{},0,2,{},
20113,1,0.333333333,1,2020-10-09T11:44:23Z,2020-10-12T11:25:49Z,3,2,1,0.333333333,2,1,0,1,{},0,1,{},Feature
20114,1,1,1,2020-10-09T17:21:22Z,2020-10-09T21:30:28Z,1,0,1,1,0,1,0,1,{},0,1,{},
20117,1,1,1,2020-10-10T08:02:18Z,2020-10-10T08:12:58Z,1,0,1,1,0,1,1,0,{'LD2': 1},1,0,{'LD2': 1},Bug
20127,1,0.333333333,1,2020-10-12T07:02:59Z,2020-10-14T08:35:34Z,3,2,1,0.333333333,1,1,0,1,{},0,1,{},"Bug,Build system"
20128,5,0.055555556,1.25,2020-10-12T07:19:58Z,2021-01-09T08:00:39Z,90,86,4,0.044444444,3,4,1,4,{'LD1': 1},1,3,{'LD1': 1},Feature
20143,1,0.1,1,2020-10-13T11:34:09Z,2020-10-22T12:20:10Z,10,9,1,0.1,1,1,1,0,{'LD2': 1},1,0,{'LD2': 1},Bug
20144,1,1,1,2020-10-13T13:36:22Z,2020-10-14T03:19:54Z,1,0,1,1,0,1,0,1,{},0,1,{},
20163,1,0.014705882,1,2020-10-16T01:41:04Z,2020-12-22T17:33:50Z,68,67,1,0.014705882,1,1,0,1,{},0,1,{},Bug
20173,1,1,1,2020-10-17T03:30:43Z,2020-10-17T03:32:01Z,1,0,1,1,0,1,1,0,{'LD2': 1},1,0,{'LD2': 1},Bug
20177,2,2,2,2020-10-17T18:02:24Z,2020-10-17T19:33:16Z,1,0,1,1,0,1,1,1,{'LD4': 1},1,0,{'LD4': 1},Bug
20208,1,1,1,2020-10-21T04:37:40Z,2020-10-21T05:22:54Z,1,0,1,1,0,1,0,1,{},0,1,{},
20227,18,0.171428571,2.25,2020-10-23T08:41:04Z,2021-02-04T20:10:13Z,105,97,8,0.076190476,7,8,5,13,"{'LD6': 1, 'LD2': 1, 'LD4': 1, 'LD3': 2}",3,5,"{'LD6': 1, 'LD2': 1, 'LD4': 1, 'LD3': 2}",Feature
20236,5,1,1.666666667,2020-10-25T11:16:39Z,2020-10-30T00:38:07Z,5,2,3,0.6,2,2,3,2,"{'LD4': 2, 'LD1': 1}",2,0,"{'LD4': 2, 'LD1': 1}",Questions and Help
20249,2,0.2,1,2020-10-26T20:45:25Z,2020-11-05T06:56:13Z,10,8,2,0.2,1,2,2,0,"{'LD2': 1, 'LD3': 1}",2,0,"{'LD2': 1, 'LD3': 1}",Bug
20259,1,1,1,2020-10-28T18:03:25Z,2020-10-28T18:12:00Z,1,0,1,1,0,1,0,1,{},0,1,{},Questions and Help
20269,1,1,1,2020-10-30T09:23:21Z,2020-10-30T10:23:55Z,1,0,1,1,0,1,0,1,{},0,1,{},
20297,1,0.125,1,2020-11-04T07:00:38Z,2020-11-11T15:12:00Z,8,7,1,0.125,2,1,1,0,{'LD6': 1},1,0,{'LD6': 1},"Bug,RPC/REST/ZMQ,Wallet"
20327,3,1,3,2020-11-06T08:40:40Z,2020-11-08T17:34:11Z,3,2,1,0.333333333,1,1,2,1,{'LD4': 2},1,0,{'LD4': 1},"Data corruption,Questions and Help,Resource usage"
20330,1,0.25,1,2020-11-06T10:56:42Z,2020-11-09T16:31:10Z,4,3,1,0.25,1,1,0,1,{},0,1,{},Bug
20338,3,0.333333333,3,2020-11-08T09:52:36Z,2020-11-17T05:57:51Z,9,8,1,0.111111111,1,2,1,2,{'LD4': 1},1,1,{'LD4': 1},Bug
20348,1,1,1,2020-11-09T01:02:17Z,2020-11-09T06:43:11Z,1,0,1,1,0,1,1,0,{'LD5': 1},1,0,{'LD5': 1},Feature
20351,5,2.5,2.5,2020-11-09T03:48:17Z,2020-11-11T03:33:56Z,2,0,2,1,0,3,1,4,{'LD6': 1},1,2,{'LD6': 1},"Bug,macOS"
20356,4,4,4,2020-11-09T18:22:33Z,2020-11-10T15:29:30Z,1,0,1,1,0,3,2,2,"{'LD3': 1, 'LD4': 1}",2,1,"{'LD3': 1, 'LD4': 1}","Bug,macOS"
20363,2,2,2,2020-11-10T19:05:12Z,2020-11-10T19:16:48Z,1,0,1,1,0,2,2,0,{'LD3': 2},2,0,{'LD3': 2},Feature
20369,1,0.5,1,2020-11-11T09:48:23Z,2020-11-12T11:27:40Z,2,1,1,0.5,1,1,0,1,{},0,1,{},Questions and Help
20376,3,0.046875,1,2020-11-12T05:20:36Z,2021-01-14T20:00:15Z,64,61,3,0.046875,3,3,2,1,"{'LD6': 1, 'LD5': 1}",2,1,"{'LD6': 1, 'LD5': 1}",Bug
20381,2,0.666666667,1,2020-11-13T05:17:58Z,2020-11-15T17:35:07Z,3,1,2,0.666666667,1,2,1,1,{'LD4': 1},1,1,{'LD4': 1},Wallet
20389,5,1.666666667,2.5,2020-11-14T16:41:47Z,2020-11-17T07:40:03Z,3,1,2,0.666666667,1,3,1,4,{'LD2': 1},1,2,{'LD2': 1},
20396,2,1,2,2020-11-15T07:40:43Z,2020-11-16T09:27:32Z,2,1,1,0.5,1,1,1,1,{'LD1': 1},1,0,{'LD1': 1},"Bug,Wallet"
20397,2,2,2,2020-11-15T14:13:15Z,2020-11-16T06:45:54Z,1,0,1,1,0,2,2,0,{'LD2': 2},2,0,{'LD2': 2},
20409,1,1,1,2020-11-17T17:25:41Z,2020-11-17T17:56:48Z,1,0,1,1,0,1,1,0,{'LD1': 1},1,0,{'LD1': 1},
20412,2,0.1,1,2020-11-18T09:51:30Z,2020-12-07T09:52:11Z,20,18,2,0.1,3,2,0,2,{},0,2,{},Build system
20439,2,2,2,2020-11-21T03:46:20Z,2020-11-21T10:30:38Z,1,0,1,1,0,1,1,1,{'LD4': 1},1,0,{'LD4': 1},Bug
20467,3,0.125,1,2020-11-23T20:05:12Z,2020-12-17T08:45:21Z,24,21,3,0.125,4,2,2,1,{'LD6': 2},1,1,{'LD6': 1},"Tests,good first issue"
20481,1,0.5,1,2020-11-24T19:20:18Z,2020-11-25T20:40:17Z,2,1,1,0.5,1,1,1,0,{'LD2': 1},1,0,{'LD2': 1},"Bug,GUI,macOS"
20488,2,2,2,2020-11-25T10:12:34Z,2020-11-25T15:13:12Z,1,0,1,1,0,2,1,1,{'LD1': 1},1,1,{'LD1': 1},"Questions and Help,Tests"
20498,3,0.2,3,2020-11-25T20:23:55Z,2020-12-10T12:18:55Z,15,14,1,0.066666667,1,2,2,1,{'LD4': 2},2,0,{'LD4': 2},
20515,4,0.095238095,1.333333333,2020-11-26T22:07:09Z,2021-01-06T23:24:18Z,42,39,3,0.071428571,3,4,1,3,{'LD5': 1},1,3,{'LD5': 1},"Feature,GUI"
20518,4,1,2,2020-11-27T11:36:29Z,2020-11-30T11:51:44Z,4,2,2,0.5,1,1,3,1,"{'LD4': 2, 'LD3': 1}",1,0,"{'LD4': 1, 'LD3': 1}","Questions and Help,Wallet"
20532,1,1,1,2020-11-30T11:42:48Z,2020-11-30T15:08:59Z,1,0,1,1,0,1,1,0,{'LD4': 1},1,0,{'LD4': 1},"Bug,RPC/REST/ZMQ,Wallet"
20542,2,2,2,2020-12-02T00:12:55Z,2020-12-02T07:47:07Z,1,0,1,1,0,2,2,0,"{'LD3': 1, 'LD4': 1}",2,0,"{'LD3': 1, 'LD4': 1}",Bug
20555,55,1.222222222,2.5,2020-12-03T08:13:24Z,2021-01-16T12:05:34Z,45,23,22,0.488888889,9,32,3,52,"{'LD1': 1, 'LD6': 1, 'LD4': 1}",3,29,"{'LD1': 1, 'LD6': 1, 'LD4': 1}",Tests
20579,13,2.6,6.5,2020-12-05T19:06:04Z,2020-12-10T10:22:27Z,5,3,2,0.4,2,5,7,6,"{'LD4': 1, 'LD3': 4, 'LD2': 2}",5,0,"{'LD4': 1, 'LD3': 3, 'LD2': 2}","Bug,Utils/log/libs"
20590,2,0.051282051,1,2020-12-07T13:51:43Z,2021-01-15T00:59:39Z,39,37,2,0.051282051,1,2,1,1,{'LD5': 1},1,1,{'LD5': 1},Bug
20604,3,3,3,2020-12-08T17:57:40Z,2020-12-08T19:16:06Z,1,0,1,1,0,2,2,1,"{'LD4': 1, 'LD3': 1}",2,0,"{'LD4': 1, 'LD3': 1}",Questions and Help
20618,3,0.230769231,1.5,2020-12-10T21:01:17Z,2020-12-23T11:34:24Z,13,11,2,0.153846154,2,3,2,1,{'LD3': 2},2,1,{'LD3': 2},Bug
20622,1,1,1,2020-12-11T08:57:14Z,2020-12-11T13:56:12Z,1,0,1,1,0,1,0,1,{},0,1,{},Bug
20637,20,6.666666667,6.666666667,2020-12-12T15:56:06Z,2020-12-15T06:53:17Z,3,0,3,1,0,7,8,12,"{'LD3': 5, 'LD1': 1, 'LD4': 1, 'LD2': 1}",4,3,"{'LD3': 3, 'LD1': 1, 'LD4': 1, 'LD2': 1}",Questions and Help
20643,1,1,1,2020-12-13T15:23:52Z,2020-12-14T08:53:02Z,1,0,1,1,0,1,1,0,{'LD4': 1},1,0,{'LD4': 1},Brainstorming
20645,1,1,1,2020-12-13T22:16:05Z,2020-12-13T22:20:20Z,1,0,1,1,0,1,1,0,{'LD2': 1},1,0,{'LD2': 1},
20647,3,1.5,1.5,2020-12-14T03:52:08Z,2020-12-15T13:54:00Z,2,0,2,1,0,2,1,2,{'LD4': 1},1,1,{'LD4': 1},Questions and Help
20672,1,1,1,2020-12-16T13:03:41Z,2020-12-16T13:18:14Z,1,0,1,1,0,1,0,1,{},0,1,{},
20693,2,2,2,2020-12-18T06:01:27Z,2020-12-18T06:10:26Z,1,0,1,1,0,2,2,0,{'LD2': 2},2,0,{'LD2': 2},Bug
20722,3,0.09375,1.5,2020-12-19T13:32:48Z,2021-01-19T16:30:38Z,32,30,2,0.0625,1,2,1,2,{'LD3': 1},1,1,{'LD3': 1},Bug
20732,2,2,2,2020-12-20T21:42:34Z,2020-12-20T22:43:23Z,1,0,1,1,0,2,2,0,{'LD4': 2},2,0,{'LD4': 2},
20742,5,5,5,2020-12-22T02:29:20Z,2020-12-22T12:26:00Z,1,0,1,1,0,4,1,4,{'LD3': 1},1,3,{'LD3': 1},Bug
20743,2,2,2,2020-12-22T03:33:09Z,2020-12-22T07:30:53Z,1,0,1,1,0,2,1,1,{'LD4': 1},1,1,{'LD4': 1},Bug
20754,5,0.208333333,1.25,2020-12-23T17:53:39Z,2021-01-15T21:26:19Z,24,20,4,0.166666667,3,3,2,3,{'LD2': 2},2,1,{'LD2': 2},Feature
20770,1,0.038461538,1,2020-12-26T10:50:17Z,2021-01-21T06:00:12Z,26,25,1,0.038461538,1,1,1,0,{'LD4': 1},1,0,{'LD4': 1},"Bug,macOS"
20777,3,0.115384615,1,2020-12-26T19:32:44Z,2021-01-21T17:52:32Z,26,23,3,0.115384615,2,2,1,2,{'LD2': 1},1,1,{'LD2': 1},"Bug,GUI"
20780,2,0.1,1,2020-12-27T17:43:39Z,2021-01-15T19:21:21Z,20,18,2,0.1,3,2,1,1,{'LD4': 1},1,1,{'LD4': 1},Bug
20792,5,0.208333333,1.666666667,2020-12-29T00:26:16Z,2021-01-21T16:50:47Z,24,21,3,0.125,2,4,2,3,{'LD1': 2},2,2,{'LD1': 2},"Bug,Windows"
20793,4,0.111111111,1.333333333,2020-12-29T04:14:52Z,2021-02-03T02:15:38Z,36,33,3,0.083333333,3,3,1,3,{'LD6': 1},1,2,{'LD6': 1},"Docs,Feature"
20821,1,1,1,2021-01-01T03:29:24Z,2021-01-01T11:20:38Z,1,0,1,1,0,1,0,1,{},0,1,{},
20825,3,3,3,2021-01-01T20:14:13Z,2021-01-02T08:41:53Z,1,0,1,1,0,1,3,0,"{'LD1': 2, 'LD4': 1}",1,0,"{'LD1': 1, 'LD4': 1}",Bug
20826,3,0.75,1,2021-01-01T22:24:19Z,2021-01-05T01:50:57Z,4,1,3,0.75,1,1,1,2,{'LD2': 1},1,0,{'LD2': 1},Bug
20831,3,1.5,1.5,2021-01-02T16:41:44Z,2021-01-03T18:12:27Z,2,0,2,1,0,1,1,2,{'LD1': 1},1,0,{'LD1': 1},"Questions and Help,Wallet"
20869,3,0.75,1.5,2021-01-06T20:50:48Z,2021-01-10T13:53:38Z,4,2,2,0.5,2,1,1,2,{'LD1': 1},1,0,{'LD1': 1},
20871,20,10,20,2021-01-06T22:57:02Z,2021-01-07T23:40:10Z,2,1,1,0.5,1,3,11,9,"{'LD2': 1, 'LD4': 3, 'LD3': 4, 'LD5': 1, 'LD1': 2}",3,0,"{'LD2': 1, 'LD4': 2, 'LD3': 3, 'LD5': 1, 'LD1': 1}",
20878,1,0.333333333,1,2021-01-07T19:41:07Z,2021-01-10T07:03:48Z,3,2,1,0.333333333,1,1,0,1,{},0,1,{},Bug
20883,1,1,1,2021-01-08T12:27:19Z,2021-01-08T13:57:34Z,1,0,1,1,0,1,0,1,{},0,1,{},
20894,8,1.6,4,2021-01-09T19:18:13Z,2021-01-14T17:17:43Z,5,3,2,0.4,1,4,4,4,"{'LD4': 2, 'LD3': 2}",3,1,"{'LD4': 1, 'LD3': 2}",Bug
20900,4,1,2,2021-01-10T15:34:24Z,2021-01-14T07:06:21Z,4,2,2,0.5,1,3,1,3,{'LD4': 1},1,2,{'LD4': 1},"Bug,Windows"
20903,2,0.666666667,2,2021-01-11T15:40:47Z,2021-01-14T07:52:53Z,3,2,1,0.333333333,1,2,2,0,"{'LD1': 1, 'LD3': 1}",2,0,"{'LD1': 1, 'LD3': 1}",
20905,2,1,1,2021-01-11T17:48:12Z,2021-01-12T23:30:24Z,2,0,2,1,0,2,1,1,{'LD2': 1},1,1,{'LD2': 1},"Bug,Wallet"
20919,1,0.125,1,2021-01-12T20:32:16Z,2021-01-19T23:44:44Z,8,7,1,0.125,1,1,0,1,{},0,1,{},"Build system,Windows"
20950,2,2,2,2021-01-16T11:59:42Z,2021-01-16T14:01:04Z,1,0,1,1,0,1,2,0,"{'LD4': 1, 'LD1': 1}",1,0,"{'LD4': 1, 'LD1': 1}",Bug
20956,1,0.333333333,1,2021-01-18T09:08:27Z,2021-01-20T12:40:15Z,3,2,1,0.333333333,1,1,0,1,{},0,1,{},Bug
20961,4,0.5,1.333333333,2021-01-19T08:32:45Z,2021-01-26T09:40:36Z,8,5,3,0.375,1,3,1,3,{'LD3': 1},1,2,{'LD3': 1},"Bug,Build system,Linux/Unix"
20973,1,1,1,2021-01-20T20:48:29Z,2021-01-20T21:22:47Z,1,0,1,1,0,1,1,0,{'LD5': 1},1,0,{'LD5': 1},
20982,1,1,1,2021-01-21T20:09:25Z,2021-01-22T03:27:57Z,1,0,1,1,0,1,0,1,{},0,1,{},"Bug,Windows"
20990,5,0.714285714,2.5,2021-01-22T20:40:44Z,2021-01-29T10:48:20Z,7,5,2,0.285714286,1,5,3,2,{'LD3': 3},3,2,{'LD3': 3},
21013,3,0.230769231,3,2021-01-26T13:55:19Z,2021-02-08T11:50:43Z,13,12,1,0.076923077,1,2,2,1,"{'LD2': 1, 'LD1': 1}",2,0,"{'LD2': 1, 'LD1': 1}",Data corruption
21019,5,1.666666667,1.666666667,2021-01-28T04:12:02Z,2021-01-30T12:59:31Z,3,0,3,1,0,3,3,2,"{'LD4': 2, 'LD3': 1}",3,0,"{'LD4': 2, 'LD3': 1}","Upstream,Utils/log/libs"
21057,2,2,2,2021-02-01T18:39:46Z,2021-02-02T09:55:52Z,1,0,1,1,0,2,1,1,{'LD5': 1},1,1,{'LD5': 1},Feature
21069,2,2,2,2021-02-03T02:50:00Z,2021-02-03T12:50:23Z,1,0,1,1,0,1,2,0,"{'LD4': 1, 'LD1': 1}",1,0,"{'LD4': 1, 'LD1': 1}","GUI,Questions and Help,RPC/REST/ZMQ"
21072,1,1,1,2021-02-03T06:30:15Z,2021-02-03T09:12:37Z,1,0,1,1,0,1,0,1,{},0,1,{},"Bug,Docs"
21076,3,3,3,2021-02-03T18:37:15Z,2021-02-03T19:15:55Z,1,0,1,1,0,3,1,2,{'LD4': 1},1,2,{'LD4': 1},
21092,3,0.6,3,2021-02-06T12:57:07Z,2021-02-10T13:31:11Z,5,4,1,0.2,1,3,3,0,{'LD3': 3},3,0,{'LD3': 3},Feature
21094,1,1,1,2021-02-06T15:20:14Z,2021-02-06T15:41:16Z,1,0,1,1,0,1,1,0,{'LD2': 1},1,0,{'LD2': 1},
21095,3,3,3,2021-02-06T16:31:00Z,2021-02-06T19:22:52Z,1,0,1,1,0,1,1,2,{'LD4': 1},1,0,{'LD4': 1},Bug
21108,1,0.25,1,2021-02-08T06:46:42Z,2021-02-11T18:33:39Z,4,3,1,0.25,2,1,0,1,{},0,1,{},"Bug,Data corruption"
21118,1,1,1,2021-02-08T16:15:55Z,2021-02-08T16:25:30Z,1,0,1,1,0,1,1,0,{'LD2': 1},1,0,{'LD2': 1},
21131,1,1,1,2021-02-09T20:39:57Z,2021-02-09T20:42:53Z,1,0,1,1,0,1,0,1,{},0,1,{},
21132,2,2,2,2021-02-09T23:59:28Z,2021-02-10T08:18:30Z,1,0,1,1,0,1,2,0,{'LD1': 2},1,0,{'LD1': 1},
